ser: S+Er
para: Pa+Ra
não: Na+O
se: Se
seu: Se+U | S+Eu
este: Es+Te
como: C+O+Mo | Co+Mo
ir: Ir
ou: O+U
eu: Eu
sobre: S+O+B+Re
esse: Es+Se
novo: N+O+V+O | No+V+O
ver: V+Er
só: S+O
país: Pa+I+S
pouco: Po+U+Co | Po+U+C+O | P+O+U+Co | P+O+U+C+O
passar: P+As+S+Ar | Pa+S+S+Ar
vir: V+Ir
ficar: F+I+C+Ar
isso: I+S+S+O
parte: P+Ar+Te
nós: N+Os | No+S | N+O+S
agora: Ag+O+Ra
caso: C+As+O | Ca+S+O
público: Pu+B+Li+Co | P+U+B+Li+Co | Pu+B+Li+C+O | P+U+B+Li+C+O
político: Po+Li+Ti+Co | P+O+Li+Ti+C+O | Po+Li+Ti+C+O | P+O+Li+Ti+Co
parecer: Pa+Re+C+Er
próprio: Pr+O+Pr+I+O
nosso: N+Os+S+O | N+O+S+S+O | No+S+S+O
continuar: C+O+N+Ti+N+U+Ar | Co+N+Ti+N+U+Ar
cerca: C+Er+Ca
final: F+In+Al | F+I+N+Al
obra: O+B+Ra
processo: Pr+O+C+Es+S+O | Pr+O+Ce+S+S+O
falar: F+Al+Ar
hora: Ho+Ra | H+O+Ra
nacional: Na+C+I+O+N+Al | N+Ac+I+O+N+Al
tão: Ta+O
conhecer: Co+N+He+C+Er | C+O+N+He+C+Er
Público: Pu+B+Li+Co | P+U+B+Li+Co | Pu+B+Li+C+O | P+U+B+Li+C+O
nunca: N+U+N+Ca
receber: Re+Ce+B+Er
social: S+O+C+I+Al
noite: No+I+Te | N+O+I+Te
único: U+Ni+C+O | U+N+I+C+O | U+N+I+Co | U+Ni+Co
principal: Pr+In+C+I+P+Al | Pr+I+N+C+I+P+Al
prever: P+Re+V+Er
viver: V+I+V+Er
esperar: Es+P+Er+Ar
acontecer: Ac+O+N+Te+C+Er
pois: Po+I+S | P+O+I+S
cinco: C+I+N+Co | C+I+N+C+O | C+In+Co | C+In+C+O
criar: Cr+I+Ar
lá: La
referir: Re+F+Er+Ir
política: Po+Li+Ti+Ca | P+O+Li+Ti+Ca
proposta: Pr+O+Po+S+Ta | Pr+O+P+O+S+Ta | Pr+O+P+Os+Ta
ganhar: Ga+Nh+Ar | Ga+N+H+Ar
frente: F+Re+N+Te
fora: F+O+Ra
através: At+Ra+V+Es
conta: Co+N+Ta | C+O+N+Ta
francês: F+Ra+N+Ce+S | F+Ra+N+C+Es
ouvir: O+U+V+Ir
início: I+Ni+C+I+O | I+N+I+C+I+O | In+I+C+I+O
internacional: In+Te+Rn+Ac+I+O+N+Al | I+N+Te+Rn+Ac+I+O+N+Al
pretender: P+Re+Te+Nd+Er
escrever: Es+C+Re+V+Er
escola: Es+C+O+La | Es+Co+La
necessário: Ne+C+Es+S+Ar+I+O | Ne+Ce+S+S+Ar+I+O
pagar: P+Ag+Ar
técnico: Te+C+N+I+Co | Te+Cn+I+C+O | Te+Cn+I+Co | Te+C+N+I+C+O | Te+C+Ni+C+O
chamar: C+H+Am+Ar
palavra: Pa+La+V+Ra
plano: P+La+No | P+La+N+O
falta: F+Al+Ta
interesse: In+Te+Re+S+Se | I+N+Te+Re+S+Se
seis: Se+I+S
surgir: S+U+Rg+Ir
tipo: Ti+P+O | Ti+Po
fundo: F+U+Nd+O
servir: S+Er+V+Ir
sob: S+O+B
incluir: I+N+C+Lu+Ir | In+C+Lu+Ir | I+N+Cl+U+Ir | In+Cl+U+Ir
vários: V+Ar+I+O+S | V+Ar+I+Os
responder: Re+S+Po+Nd+Er | Re+S+P+O+Nd+Er
claro: Cl+Ar+O
pai: Pa+I
clube: Cl+U+Be | C+Lu+Be
gente: Ge+N+Te
acusar: Ac+U+S+Ar
socialista: S+O+C+I+Al+I+S+Ta
ali: Al+I
campo: C+Am+P+O | C+Am+Po
participar: P+Ar+Ti+C+I+P+Ar
financeiro: F+I+Na+N+Ce+Ir+O
americano: Am+Er+I+Ca+No | Am+Er+I+Ca+N+O
presente: P+Re+Se+N+Te
princípio: Pr+I+N+C+I+P+I+O | Pr+In+C+I+P+I+O
base: Ba+Se
fonte: F+O+N+Te
provocar: Pr+O+V+O+C+Ar
várias: V+Ar+I+As
concluir: Co+N+C+Lu+Ir | C+O+N+Cl+U+Ir | C+O+N+C+Lu+Ir | Co+N+Cl+U+Ir
resposta: Re+S+Po+S+Ta | Re+S+P+Os+Ta | Re+S+P+O+S+Ta
achar: Ac+H+Ar
povo: Po+V+O | P+O+V+O
resolver: Re+S+O+Lv+Er
oficial: O+F+I+C+I+Al
reconhecer: Re+Co+N+He+C+Er | Re+C+O+N+He+C+Er
Benfica: Be+N+F+I+Ca
carta: C+Ar+Ta
caminho: C+Am+I+Nh+O | C+Am+I+N+H+O | C+Am+In+Ho | C+Am+In+H+O | C+Am+I+N+Ho
publicar: P+U+B+Li+C+Ar | Pu+B+Li+C+Ar
banco: Ba+N+Co | Ba+N+C+O
cair: Ca+Ir
luta: Lu+Ta
preciso: P+Re+C+I+S+O
usar: U+S+Ar
sofrer: S+O+Fr+Er
lista: Li+S+Ta
assinar: As+S+I+N+Ar | As+Si+N+Ar | As+S+In+Ar
reunir: Re+U+N+Ir
ambos: Am+B+Os | Am+B+O+S
sete: Se+Te
chefe: C+He+Fe
acesso: Ac+Es+S+O
ocupar: O+C+U+P+Ar | O+Cu+P+Ar
profissional: Pr+O+F+I+S+S+I+O+N+Al | Pr+O+F+I+S+Si+O+N+Al
crise: Cr+I+Se
preparar: P+Re+P+Ar+Ar
subir: S+U+B+Ir
pessoal: P+Es+S+O+Al
aliás: Al+I+As
visita: V+I+Si+Ta | V+I+S+I+Ta
sublinhar: S+U+B+Li+N+H+Ar | S+U+B+Li+Nh+Ar
representante: Re+P+Re+Se+N+Ta+N+Te
aluno: Al+U+N+O | Al+U+No
recente: Re+Ce+N+Te
iniciar: I+Ni+C+I+Ar | I+N+I+C+I+Ar | In+I+C+I+Ar
nascer: N+As+C+Er | Na+S+C+Er | Na+Sc+Er
hipótese: H+I+Po+Te+Se | H+I+P+O+Te+Se
funcionar: F+U+N+C+I+O+N+Ar
britânico: Br+I+Ta+Ni+Co | Br+I+Ta+N+I+Co | Br+I+Ta+N+I+C+O | Br+I+Ta+Ni+C+O
sinal: S+I+N+Al | S+In+Al | Si+N+Al
gestão: Ge+S+Ta+O
bastante: Ba+S+Ta+N+Te | B+As+Ta+N+Te
arte: Ar+Te
branco: B+Ra+N+Co | B+Ra+N+C+O
livre: Li+V+Re
oferecer: O+Fe+Re+C+Er
real: Re+Al
verificar: V+Er+I+F+I+C+Ar
cargo: Ca+Rg+O
russo: Ru+S+S+O
fechar: Fe+C+H+Ar
precisar: P+Re+C+I+S+Ar
promover: Pr+O+Mo+V+Er
ar: Ar
passo: P+As+S+O | Pa+S+S+O
festa: Fe+S+Ta | F+Es+Ta
restante: Re+S+Ta+N+Te
bater: B+At+Er
vós: V+Os | V+O+S
indicar: I+Nd+I+C+Ar
vista: V+I+S+Ta
prática: Pr+At+I+Ca | P+Ra+Ti+Ca
funcionário: F+U+N+C+I+O+N+Ar+I+O
recusar: Re+C+U+S+Ar | Re+Cu+S+Ar
teu: Te+U
carreira: C+Ar+Re+I+Ra
Paris: P+Ar+I+S
fogo: F+Og+O
motivo: Mo+Ti+V+O
centena: Ce+N+Te+Na
sucesso: S+U+C+Es+S+O | S+U+Ce+S+S+O
valer: V+Al+Er
crítica: Cr+I+Ti+Ca
interno: I+N+Te+Rn+O | In+Te+Rn+O
vivo: V+I+V+O
positivo: P+Os+I+Ti+V+O | Po+S+I+Ti+V+O | Po+Si+Ti+V+O | P+O+Si+Ti+V+O | P+O+S+I+Ti+V+O
pertencer: P+Er+Te+N+C+Er
sérvio: S+Er+V+I+O
parar: P+Ar+Ar
pobre: P+O+B+Re | Po+B+Re
rei: Re+I
ora: O+Ra
perceber: P+Er+Ce+B+Er
preferir: P+Re+F+Er+Ir
canal: Ca+N+Al
crescer: Cr+Es+C+Er | C+Re+Sc+Er | C+Re+S+C+Er
vosso: V+Os+S+O | V+O+S+S+O
revista: Re+V+I+S+Ta
bola: B+O+La
recuperar: Re+C+U+P+Er+Ar | Re+Cu+P+Er+Ar
relativo: Re+La+Ti+V+O
crítico: Cr+I+Ti+Co | Cr+I+Ti+C+O
possuir: Po+S+S+U+Ir | P+O+S+S+U+Ir | P+Os+S+U+Ir
artista: Ar+Ti+S+Ta
verba: V+Er+Ba
prender: P+Re+Nd+Er
causar: C+Au+S+Ar | Ca+U+S+Ar
caber: Ca+B+Er
peso: P+Es+O
página: P+Ag+I+Na
Braga: B+Ra+Ga
república: Re+P+U+B+Li+Ca | Re+Pu+B+Li+Ca
provar: Pr+O+V+Ar
criticar: Cr+I+Ti+C+Ar
fronteira: Fr+O+N+Te+I+Ra
índice: I+Nd+I+Ce
interessar: I+N+Te+Re+S+S+Ar | In+Te+Re+S+S+Ar
atrás: At+Ra+S
cenário: Ce+N+Ar+I+O
nota: No+Ta | N+O+Ta
ponte: Po+N+Te | P+O+N+Te
sério: S+Er+I+O
largo: La+Rg+O
cena: Ce+Na
cá: Ca
preocupar: P+Re+O+C+U+P+Ar | P+Re+O+Cu+P+Ar
general: Ge+N+Er+Al
procura: Pr+O+C+U+Ra | Pr+O+Cu+Ra
senhora: Se+N+Ho+Ra | Se+N+H+O+Ra | Se+Nh+O+Ra
referendo: Re+Fe+Re+Nd+O
classe: C+La+S+Se | Cl+As+Se
fiscal: F+I+S+C+Al | F+I+Sc+Al
visar: V+I+S+Ar
sindicato: Si+Nd+I+C+At+O | S+I+Nd+I+C+At+O
profundo: Pr+O+F+U+Nd+O
palco: P+Al+Co | P+Al+C+O
foi: F+O+I
esclarecer: Es+C+La+Re+C+Er
essencial: Es+Se+N+C+I+Al
cheio: C+He+I+O
gabinete: Ga+B+I+Ne+Te | Ga+Bi+Ne+Te
familiar: F+Am+I+Li+Ar
atraso: At+Ra+S+O
accionista: Ac+C+I+O+Ni+S+Ta | Ac+C+I+O+N+I+S+Ta
receita: Re+Ce+I+Ta
cabo: Ca+B+O
esconder: Es+C+O+Nd+Er | Es+Co+Nd+Er
consumo: Co+N+S+U+Mo | C+O+N+S+U+Mo
cobrir: C+O+Br+Ir | Co+Br+Ir
céu: Ce+U | C+Eu
classificar: Cl+As+S+I+F+I+C+Ar | C+La+S+Si+F+I+C+Ar | C+La+S+S+I+F+I+C+Ar | Cl+As+Si+F+I+C+Ar
atuar: At+U+Ar
crer: Cr+Er
salário: S+Al+Ar+I+O
negativo: Ne+Ga+Ti+V+O
alvo: Al+V+O
activo: Ac+Ti+V+O
praticar: P+Ra+Ti+C+Ar | Pr+At+I+C+Ar
vinho: V+In+H+O | V+I+Nh+O | V+In+Ho | V+I+N+H+O | V+I+N+Ho
observar: O+B+S+Er+V+Ar
optar: O+Pt+Ar
ciclo: C+I+Cl+O
físico: F+I+Si+C+O | F+I+Si+Co | F+I+S+I+Co | F+I+S+I+C+O
chinês: C+H+I+Ne+S | C+H+I+N+Es | C+H+In+Es
beneficiar: Be+Ne+F+I+C+I+Ar
atravessar: At+Ra+V+Es+S+Ar
China: C+H+I+Na
pp: P+P
sonho: S+O+Nh+O | S+O+N+H+O | S+O+N+Ho
montante: Mo+N+Ta+N+Te
atacar: At+Ac+Ar
inicial: I+N+I+C+I+Al | In+I+C+I+Al | I+Ni+C+I+Al
uso: U+S+O
casar: Ca+S+Ar | C+As+Ar
relacionar: Re+La+C+I+O+N+Ar
incêndio: In+Ce+Nd+I+O | I+N+Ce+Nd+I+O
Bruxelas: Br+U+Xe+La+S | B+Ru+Xe+La+S
ligeiro: Li+Ge+Ir+O
senão: Se+Na+O
honra: Ho+N+Ra | H+O+N+Ra
assinalar: As+S+In+Al+Ar | As+S+I+N+Al+Ar | As+Si+N+Al+Ar
Unita: U+N+I+Ta | U+Ni+Ta
viatura: V+I+At+U+Ra
salvar: S+Al+V+Ar
frio: Fr+I+O
clássico: C+La+S+S+I+C+O | Cl+As+S+I+Co | C+La+S+Si+Co | C+La+S+Si+C+O | C+La+S+S+I+Co | Cl+As+Si+Co | Cl+As+S+I+C+O | Cl+As+Si+C+O
confessar: Co+N+F+Es+S+Ar | C+O+N+Fe+S+S+Ar | Co+N+Fe+S+S+Ar | C+O+N+F+Es+S+Ar
policial: Po+Li+C+I+Al | P+O+Li+C+I+Al
posse: Po+S+Se | P+Os+Se | P+O+S+Se
convocar: C+O+N+V+O+C+Ar | Co+N+V+O+C+Ar
timorense: Ti+Mo+Re+N+Se
católico: C+At+O+Li+C+O | C+At+O+Li+Co
Moscovo: Mo+Sc+O+V+O | Mo+S+Co+V+O | Mo+S+C+O+V+O
falso: F+Al+S+O
parceiro: P+Ar+Ce+Ir+O
oferta: O+F+Er+Ta
bispo: B+I+S+P+O | B+I+S+Po | Bi+S+P+O | Bi+S+Po
amar: Am+Ar
barco: B+Ar+C+O | B+Ar+Co
festival: F+Es+Ti+V+Al | Fe+S+Ti+V+Al
teste: Te+S+Te
participante: P+Ar+Ti+C+I+Pa+N+Te
assinatura: As+S+I+N+At+U+Ra | As+Si+N+At+U+Ra | As+S+In+At+U+Ra
indonésio: I+Nd+O+N+Es+I+O | I+Nd+O+Ne+S+I+O | I+Nd+O+Ne+Si+O
sindical: Si+Nd+I+C+Al | S+I+Nd+I+C+Al
género: Ge+N+Er+O
fraco: Fr+Ac+O | F+Ra+Co | F+Ra+C+O
famoso: F+Am+O+S+O | F+Am+Os+O
reagir: Re+Ag+Ir
você: V+O+Ce
pista: P+I+S+Ta
arrancar: Ar+Ra+N+C+Ar
separar: Se+P+Ar+Ar
reclamar: Re+Cl+Am+Ar
inteiro: In+Te+Ir+O | I+N+Te+Ir+O
virar: V+Ir+Ar
constante: Co+N+S+Ta+N+Te | C+O+N+S+Ta+N+Te
pesar: P+Es+Ar
par: P+Ar
convite: Co+N+V+I+Te | C+O+N+V+I+Te
navio: Na+V+I+O
lucro: Lu+Cr+O
vinte: V+I+N+Te | V+In+Te
visitante: V+I+S+I+Ta+N+Te | V+I+Si+Ta+N+Te
boca: B+O+Ca
restaurante: Re+S+Ta+U+Ra+N+Te
associar: As+S+O+C+I+Ar
frase: F+Ra+Se
Cavaco: Ca+V+Ac+O
secundário: Se+Cu+Nd+Ar+I+O | Se+C+U+Nd+Ar+I+O
proibir: Pr+O+I+B+Ir
cristão: Cr+I+S+Ta+O
cartão: C+Ar+Ta+O
sítio: Si+Ti+O | S+I+Ti+O
sócio: S+O+C+I+O
falhar: F+Al+H+Ar
gás: Ga+S
tese: Te+Se
buscar: B+U+S+C+Ar | B+U+Sc+Ar
vila: V+I+La
Viseu: V+I+Se+U | V+I+S+Eu
basear: Ba+Se+Ar
casal: Ca+S+Al | C+As+Al
liga: Li+Ga
feira: Fe+I+Ra
bancário: Ba+N+C+Ar+I+O
atirar: At+Ir+Ar
ferir: F+Er+Ir
crescente: Cr+Es+Ce+N+Te | C+Re+S+Ce+N+Te
cara: Ca+Ra
técnica: Te+Cn+I+Ca | Te+C+Ni+Ca | Te+C+N+I+Ca
fé: Fe
caro: C+Ar+O
beber: Be+B+Er
holandês: H+O+La+Nd+Es | Ho+La+Nd+Es
nato: N+At+O
fuga: F+U+Ga
reservar: Re+S+Er+V+Ar
escapar: Es+Ca+P+Ar
árvore: Ar+V+O+Re
carne: C+Ar+Ne
universo: U+N+I+V+Er+S+O | U+Ni+V+Er+S+O
continente: Co+N+Ti+Ne+N+Te | C+O+N+Ti+Ne+N+Te
básico: Ba+Si+C+O | Ba+S+I+C+O | B+As+I+C+O | Ba+S+I+Co | B+As+I+Co | Ba+Si+Co
aula: Au+La
variar: V+Ar+I+Ar
Soares: S+O+Ar+Es
acaso: Ac+As+O
cavalo: Ca+V+Al+O
artístico: Ar+Ti+S+Ti+Co | Ar+Ti+S+Ti+C+O
papa: Pa+Pa
patente: Pa+Te+N+Te
carga: C+Ar+Ga
receio: Re+Ce+I+O
benefício: Be+Ne+F+I+C+I+O
liberal: Li+B+Er+Al
rapariga: Ra+P+Ar+I+Ga
acerca: Ac+Er+Ca
palácio: Pa+La+C+I+O | P+Al+Ac+I+O
busca: B+U+S+Ca
oh: O+H
América: Am+Er+I+Ca
seio: Se+I+O
consenso: C+O+N+Se+N+S+O | Co+N+Se+N+S+O
escala: Es+Ca+La
noticiar: N+O+Ti+C+I+Ar | No+Ti+C+I+Ar
pronunciar: Pr+O+N+U+N+C+I+Ar
progresso: Pr+Og+Re+S+S+O
estender: Es+Te+Nd+Er
costas: C+Os+Ta+S | Co+S+Ta+S | C+O+S+Ta+S
financiar: F+I+Na+N+C+I+Ar
intenso: I+N+Te+N+S+O | In+Te+N+S+O
bar: B+Ar
café: Ca+Fe
nobre: N+O+B+Re | No+B+Re
prático: P+Ra+Ti+Co | Pr+At+I+Co | Pr+At+I+C+O | P+Ra+Ti+C+O
fundar: F+U+Nd+Ar
motivar: Mo+Ti+V+Ar
herói: H+Er+O+I
escândalo: Es+Ca+Nd+Al+O
frisar: Fr+I+S+Ar
operar: O+P+Er+Ar
óbvio: O+B+V+I+O
pesca: P+Es+Ca
conceber: Co+N+Ce+B+Er | C+O+N+Ce+B+Er
reino: Re+In+O | Re+I+No | Re+I+N+O
perna: P+Er+Na
passeio: P+As+Se+I+O | Pa+S+Se+I+O
capitão: Ca+P+I+Ta+O
franco: F+Ra+N+C+O | F+Ra+N+Co
fecho: Fe+C+Ho | Fe+C+H+O
rever: Re+V+Er
plástico: P+La+S+Ti+Co | P+La+S+Ti+C+O
bosnio: B+Os+N+I+O | B+O+S+N+I+O | B+O+Sn+I+O | B+O+S+Ni+O | B+Os+Ni+O
barreira: B+Ar+Re+I+Ra
conservar: C+O+N+S+Er+V+Ar | Co+N+S+Er+V+Ar
camarário: C+Am+Ar+Ar+I+O
inspirar: I+N+S+P+Ir+Ar | In+S+P+Ir+Ar
pacífico: P+Ac+I+F+I+Co | Pa+C+I+F+I+Co | Pa+C+I+F+I+C+O | P+Ac+I+F+I+C+O
sucessivo: S+U+C+Es+S+I+V+O | S+U+C+Es+Si+V+O | S+U+Ce+S+Si+V+O | S+U+Ce+S+S+I+V+O
alternativo: Al+Te+Rn+At+I+V+O
cancro: Ca+N+Cr+O
costa: C+O+S+Ta | C+Os+Ta | Co+S+Ta
cão: Ca+O
atrair: At+Ra+Ir
unir: U+N+Ir
condicionar: Co+Nd+I+C+I+O+N+Ar | C+O+Nd+I+C+I+O+N+Ar
Natal: N+At+Al
Sampaio: S+Am+Pa+I+O
lance: La+N+Ce
agravar: Ag+Ra+V+Ar
ramo: Ra+Mo
autêntico: Au+Te+N+Ti+C+O | Au+Te+N+Ti+Co
sobreviver: S+O+B+Re+V+I+V+Er
recear: Re+Ce+Ar
inscrever: I+N+Sc+Re+V+Er | In+Sc+Re+V+Er | I+N+S+C+Re+V+Er | In+S+C+Re+V+Er
vírus: V+Ir+U+S | V+I+Ru+S
republicano: Re+Pu+B+Li+Ca+N+O | Re+P+U+B+Li+Ca+N+O | Re+P+U+B+Li+Ca+No | Re+Pu+B+Li+Ca+No
agir: Ag+Ir
espalhar: Es+P+Al+H+Ar
Não: Na+O
consecutivo: Co+N+Se+C+U+Ti+V+O | Co+N+Se+Cu+Ti+V+O | C+O+N+Se+Cu+Ti+V+O | C+O+N+Se+C+U+Ti+V+O
renovar: Re+N+O+V+Ar | Re+No+V+Ar
convir: C+O+N+V+Ir | Co+N+V+Ir
planeta: P+La+Ne+Ta
ascender: As+Ce+Nd+Er
monte: Mo+N+Te
mover: Mo+V+Er
invocar: I+N+V+O+C+Ar | In+V+O+C+Ar
poupar: P+O+U+P+Ar | Po+U+P+Ar
hectare: He+C+Ta+Re
reparar: Re+P+Ar+Ar
tender: Te+Nd+Er
pressionar: P+Re+S+S+I+O+N+Ar | Pr+Es+Si+O+N+Ar | Pr+Es+S+I+O+N+Ar | P+Re+S+Si+O+N+Ar
recuar: Re+Cu+Ar | Re+C+U+Ar
alinhar: Al+In+H+Ar | Al+I+N+H+Ar | Al+I+Nh+Ar
confiar: C+O+N+F+I+Ar | Co+N+F+I+Ar
pacote: Pa+C+O+Te | P+Ac+O+Te | Pa+Co+Te
escasso: Es+C+As+S+O | Es+Ca+S+S+O
operário: O+P+Er+Ar+I+O
buraco: B+U+Ra+Co | B+U+Ra+C+O
assassinar: As+S+As+S+In+Ar | As+S+As+Si+N+Ar | As+S+As+S+I+N+Ar
preso: Pr+Es+O | P+Re+S+O
floresta: Fl+O+Re+S+Ta
sonhar: S+O+Nh+Ar | S+O+N+H+Ar
piso: P+I+S+O
clandestino: C+La+Nd+Es+Ti+N+O | C+La+Nd+Es+Ti+No
verso: V+Er+S+O
proferir: Pr+O+F+Er+Ir
barato: B+Ar+At+O
banho: Ba+N+H+O | Ba+N+Ho | Ba+Nh+O
ponta: Po+N+Ta | P+O+N+Ta
propina: Pr+O+P+I+Na
nacionalista: Na+C+I+O+Na+Li+S+Ta | Na+C+I+O+N+Al+I+S+Ta | N+Ac+I+O+N+Al+I+S+Ta | N+Ac+I+O+Na+Li+S+Ta
reivindicar: Re+I+V+I+Nd+I+C+Ar
referente: Re+Fe+Re+N+Te
alheio: Al+He+I+O
salarial: S+Al+Ar+I+Al
alerta: Al+Er+Ta
atrasar: At+Ra+S+Ar
beira: Be+I+Ra
utente: U+Te+N+Te
biblioteca: Bi+B+Li+O+Te+Ca | B+I+B+Li+O+Te+Ca
pasta: Pa+S+Ta | P+As+Ta
célula: Ce+Lu+La
caminhar: C+Am+I+Nh+Ar | C+Am+In+H+Ar | C+Am+I+N+H+Ar
passe: P+As+Se | Pa+S+Se
futebolista: F+U+Te+B+O+Li+S+Ta
parcial: P+Ar+C+I+Al
pão: Pa+O
ruptura: Ru+Pt+U+Ra
patrão: P+At+Ra+O
libra: Li+B+Ra
banca: Ba+N+Ca
conversar: C+O+N+V+Er+S+Ar | Co+N+V+Er+S+Ar
cigano: C+I+Ga+N+O | C+I+Ga+No
acrescer: Ac+Re+S+C+Er | Ac+Re+Sc+Er
conferir: C+O+N+F+Er+Ir | Co+N+F+Er+Ir
Cascais: C+As+Ca+I+S | Ca+S+Ca+I+S
subscrever: S+U+B+S+C+Re+V+Er | S+U+B+Sc+Re+V+Er
sugestão: S+U+Ge+S+Ta+O
contínuo: Co+N+Ti+N+U+O | C+O+N+Ti+N+U+O
tabela: Ta+Be+La
prévio: P+Re+V+I+O
Cuba: Cu+Ba | C+U+Ba
vago: V+Ag+O
in: I+N | In
clínico: C+Li+N+I+C+O | Cl+I+Ni+C+O | C+Li+N+I+Co | Cl+I+N+I+C+O | Cl+I+Ni+Co | Cl+I+N+I+Co | Cl+In+I+Co | C+Li+Ni+C+O | Cl+In+I+C+O
vertente: V+Er+Te+N+Te
Monteiro: Mo+N+Te+Ir+O
rumo: Ru+Mo
fio: F+I+O
serra: S+Er+Ra
inserir: In+S+Er+Ir | I+N+S+Er+Ir
instante: I+N+S+Ta+N+Te | In+S+Ta+N+Te
confundir: Co+N+F+U+Nd+Ir | C+O+N+F+U+Nd+Ir
saco: S+Ac+O
espacial: Es+P+Ac+I+Al | Es+Pa+C+I+Al
fresco: F+Re+S+Co | Fr+Es+C+O | Fr+Es+Co | F+Re+Sc+O | F+Re+S+C+O
cubano: Cu+Ba+No | Cu+Ba+N+O | C+U+Ba+N+O | C+U+Ba+No
ho: H+O | Ho
imobiliário: I+Mo+B+I+Li+Ar+I+O | I+Mo+Bi+Li+Ar+I+O
cineasta: C+I+Ne+As+Ta
seco: Se+C+O | Se+Co
render: Re+Nd+Er
prata: P+Ra+Ta
ausente: Au+Se+N+Te
representativo: Re+P+Re+Se+N+Ta+Ti+V+O
potencial: P+O+Te+N+C+I+Al | Po+Te+N+C+I+Al
irlandês: Ir+La+Nd+Es
universal: U+Ni+V+Er+S+Al | U+N+I+V+Er+S+Al
inverno: I+N+V+Er+N+O | In+V+Er+No | I+N+V+Er+No | In+V+Er+N+O
polaco: Po+La+Co | Po+La+C+O | P+O+La+Co | P+O+La+C+O
brincar: Br+I+N+C+Ar | Br+In+C+Ar
tencionar: Te+N+C+I+O+N+Ar
potenciar: Po+Te+N+C+I+Ar | P+O+Te+N+C+I+Ar
raio: Ra+I+O
asiático: As+I+At+I+Co | As+I+At+I+C+O
preservar: P+Re+S+Er+V+Ar | Pr+Es+Er+V+Ar
barraca: B+Ar+Ra+Ca
voo: V+O+O
helicóptero: He+Li+Co+Pt+Er+O | He+Li+C+O+Pt+Er+O
custa: Cu+S+Ta | C+U+S+Ta
ruína: Ru+I+Na
superar: S+U+P+Er+Ar
carteira: C+Ar+Te+I+Ra
ténis: Te+N+I+S | Te+Ni+S
contente: Co+N+Te+N+Te | C+O+N+Te+N+Te
ganho: Ga+N+Ho | Ga+Nh+O | Ga+N+H+O
escrita: Es+Cr+I+Ta
cansar: Ca+N+S+Ar
incentivo: In+Ce+N+Ti+V+O | I+N+Ce+N+Ti+V+O
coluna: C+O+Lu+Na | Co+Lu+Na
revolucionário: Re+V+O+Lu+C+I+O+N+Ar+I+O
escalão: Es+Ca+La+O
operacional: O+P+Er+Ac+I+O+N+Al
fila: F+I+La
per: P+Er
cobrar: Co+Br+Ar | C+O+Br+Ar
típico: Ti+P+I+C+O | Ti+P+I+Co
piscina: P+I+S+C+I+Na | P+I+Sc+I+Na
Genebra: Ge+Ne+B+Ra
nu: N+U
Irão: I+Ra+O
precioso: P+Re+C+I+O+S+O | P+Re+C+I+Os+O
heroína: H+Er+O+I+Na
voar: V+O+Ar
inocente: I+No+Ce+N+Te | In+O+Ce+N+Te | I+N+O+Ce+N+Te
atmosfera: At+Mo+S+Fe+Ra
assassínio: As+S+As+Si+N+I+O | As+S+As+S+I+N+I+O | As+S+As+Si+Ni+O | As+S+As+S+I+Ni+O | As+S+As+S+In+I+O
alcance: Al+Ca+N+Ce
passear: P+As+Se+Ar | Pa+S+Se+Ar
fino: F+I+N+O | F+In+O | F+I+No
pano: Pa+N+O | Pa+No
capa: Ca+Pa
censura: Ce+N+S+U+Ra
supremo: S+U+P+Re+Mo
frota: Fr+O+Ta
bebé: Be+Be
calhar: C+Al+H+Ar
tio: Ti+O
íntimo: In+Ti+Mo | I+N+Ti+Mo
aliar: Al+I+Ar
proclamar: Pr+O+Cl+Am+Ar
preocupante: P+Re+O+C+U+Pa+N+Te | P+Re+O+Cu+Pa+N+Te
processar: Pr+O+Ce+S+S+Ar | Pr+O+C+Es+S+Ar
ofício: O+F+I+C+I+O
estacionar: Es+Ta+C+I+O+N+Ar
cérebro: Ce+Re+Br+O
inteligente: In+Te+Li+Ge+N+Te | I+N+Te+Li+Ge+N+Te
primo: Pr+I+Mo
asser: As+S+Er
cambial: C+Am+Bi+Al | C+Am+B+I+Al
planta: P+La+N+Ta
barra: B+Ar+Ra
albanês: Al+Ba+Ne+S | Al+Ba+N+Es
fatal: F+At+Al
passivo: P+As+S+I+V+O | Pa+S+S+I+V+O | Pa+S+Si+V+O | P+As+Si+V+O
prisioneiro: Pr+I+S+I+O+Ne+Ir+O | Pr+I+Si+O+Ne+Ir+O
cercar: C+Er+C+Ar
fracasso: Fr+Ac+As+S+O | F+Ra+Ca+S+S+O | F+Ra+C+As+S+O
largar: La+Rg+Ar
indício: I+Nd+I+C+I+O
sétimo: Se+Ti+Mo
Funchal: F+U+N+C+H+Al
calmo: C+Al+Mo
Espinho: Es+P+In+H+O | Es+P+I+Nh+O | Es+P+I+N+Ho | Es+P+In+Ho | Es+P+I+N+H+O
planear: P+La+Ne+Ar
argentino: Ar+Ge+N+Ti+N+O | Ar+Ge+N+Ti+No
catálogo: C+At+Al+Og+O
pop: P+O+P | Po+P
nervoso: N+Er+V+O+S+O | N+Er+V+Os+O
estatística: Es+Ta+Ti+S+Ti+Ca
réu: Re+U
nó: No | N+O
placa: P+La+Ca
vário: V+Ar+I+O
cheiro: C+He+Ir+O
conduta: Co+Nd+U+Ta | C+O+Nd+U+Ta
genético: Ge+Ne+Ti+C+O | Ge+Ne+Ti+Co
opa: O+Pa
ousar: O+U+S+Ar
prato: Pr+At+O
argelino: Ar+Ge+Li+No | Ar+Ge+Li+N+O
horas: Ho+Ra+S | H+O+Ra+S
lavar: La+V+Ar
ponderar: Po+Nd+Er+Ar | P+O+Nd+Er+Ar
balcão: B+Al+Ca+O
caos: Ca+O+S | Ca+Os
soar: S+O+Ar
tabaco: Ta+Ba+Co | Ta+Ba+C+O | Ta+B+Ac+O
Faro: F+Ar+O
vôo: V+O+O
cívico: C+I+V+I+C+O | C+I+V+I+Co
ovo: O+V+O
fumo: F+U+Mo
assassino: As+S+As+S+I+N+O | As+S+As+S+In+O | As+S+As+Si+No | As+S+As+S+I+No | As+S+As+Si+N+O
respirar: Re+S+P+Ir+Ar
substancial: S+U+B+S+Ta+N+C+I+Al
chefiar: C+He+F+I+Ar
Argentina: Ar+Ge+N+Ti+Na
chocar: C+Ho+C+Ar | C+H+O+C+Ar
professora: Pr+O+F+Es+S+O+Ra | Pr+O+Fe+S+S+O+Ra
assente: As+Se+N+Te
estético: Es+Te+Ti+Co | Es+Te+Ti+C+O
fato: F+At+O
gene: Ge+Ne
punir: P+U+N+Ir | Pu+N+Ir
génio: Ge+N+I+O | Ge+Ni+O
indiferente: I+Nd+I+Fe+Re+N+Te
amiga: Am+I+Ga
agressivo: Ag+Re+S+S+I+V+O | Ag+Re+S+Si+V+O
pertencente: P+Er+Te+N+Ce+N+Te
gasolina: Ga+S+O+Li+Na
Para: Pa+Ra
windows: W+I+Nd+O+W+S
lindo: Li+Nd+O
inferno: I+N+Fe+Rn+O | In+F+Er+No | In+F+Er+N+O | I+N+F+Er+No | In+Fe+Rn+O | I+N+F+Er+N+O
Kosovo: K+O+S+O+V+O | K+Os+O+V+O
copo: Co+Po | Co+P+O | C+O+P+O | C+O+Po
ofensivo: O+Fe+N+Si+V+O | O+Fe+N+S+I+V+O
calar: C+Al+Ar
cessar: Ce+S+S+Ar | C+Es+S+Ar
ambicioso: Am+Bi+C+I+Os+O | Am+Bi+C+I+O+S+O | Am+B+I+C+I+Os+O | Am+B+I+C+I+O+S+O
acréscimo: Ac+Re+S+C+I+Mo | Ac+Re+Sc+I+Mo
ciclista: C+I+Cl+I+S+Ta | C+I+C+Li+S+Ta
assaltante: As+S+Al+Ta+N+Te
capacete: Ca+Pa+Ce+Te
casaco: Ca+S+Ac+O | C+As+Ac+O
oeste: O+Es+Te
assistente: As+S+I+S+Te+N+Te | As+Si+S+Te+N+Te
captar: Ca+Pt+Ar
generoso: Ge+N+Er+Os+O | Ge+N+Er+O+S+O
visual: V+I+S+U+Al
Vaticano: V+At+I+Ca+No | V+At+I+Ca+N+O
nam: N+Am
foco: F+O+Co | F+O+C+O
camisola: C+Am+I+S+O+La
progressivo: Pr+Og+Re+S+Si+V+O | Pr+Og+Re+S+S+I+V+O
Bush: B+U+S+H
pó: P+O | Po
Famalicão: F+Am+Al+I+Ca+O
artificial: Ar+Ti+F+I+C+I+Al
Costa: C+O+S+Ta | C+Os+Ta | Co+S+Ta
barão: Ba+Ra+O
Bona: B+O+Na
osso: Os+S+O | O+S+S+O
poste: Po+S+Te | P+Os+Te | P+O+S+Te
sindicalista: Si+Nd+I+C+Al+I+S+Ta | Si+Nd+I+Ca+Li+S+Ta | S+I+Nd+I+C+Al+I+S+Ta | S+I+Nd+I+Ca+Li+S+Ta
cocaína: Co+Ca+I+Na | C+O+Ca+I+Na
associativo: As+S+O+C+I+At+I+V+O
síntese: S+In+Te+Se | S+I+N+Te+Se | Si+N+Te+Se
tenista: Te+Ni+S+Ta | Te+N+I+S+Ta
oitavo: O+I+Ta+V+O
racismo: Ra+C+I+S+Mo | Ra+C+I+Sm+O
convívio: Co+N+V+I+V+I+O | C+O+N+V+I+V+I+O
geográfico: Ge+Og+Ra+F+I+Co | Ge+Og+Ra+F+I+C+O
senso: Se+N+S+O
vício: V+I+C+I+O
bala: Ba+La
mosteiro: Mo+S+Te+Ir+O
índio: I+Nd+I+O
sobrar: S+O+Br+Ar
criativo: Cr+I+At+I+V+O
arco: Ar+C+O | Ar+Co
principiar: Pr+I+N+C+I+P+I+Ar | Pr+In+C+I+P+I+Ar
protestante: Pr+O+Te+S+Ta+N+Te
tecer: Te+C+Er
barba: B+Ar+Ba
pneu: P+Ne+U | P+N+Eu
Bundesbank: B+U+Nd+Es+Ba+N+K
precário: P+Re+C+Ar+I+O
reinar: Re+In+Ar | Re+I+N+Ar
ratificar: Ra+Ti+F+I+C+Ar
boicote: B+O+I+Co+Te | B+O+I+C+O+Te
cofre: C+O+F+Re | Co+F+Re
nipônico: Ni+P+O+Ni+C+O | Ni+Po+N+I+C+O | N+I+P+O+N+I+C+O | Ni+P+O+N+I+C+O | N+I+Po+N+I+C+O | N+I+P+O+Ni+C+O | N+I+Po+Ni+Co | Ni+Po+Ni+Co | Ni+P+O+N+I+Co | Ni+Po+Ni+C+O | N+I+P+O+N+I+Co | Ni+P+O+Ni+Co
catalão: Ca+Ta+La+O
Barreiro: B+Ar+Re+Ir+O
sono: S+O+No | S+O+N+O
seita: Se+I+Ta
centenário: Ce+N+Te+N+Ar+I+O
febre: Fe+B+Re
sereno: Se+Re+No | Se+Re+N+O
sal: S+Al
genérico: Ge+N+Er+I+C+O | Ge+N+Er+I+Co
lábio: La+Bi+O | La+B+I+O
esfera: Es+Fe+Ra
realista: Re+Al+I+S+Ta
tinta: Ti+N+Ta
parcela: P+Ar+Ce+La
incentivar: I+N+Ce+N+Ti+V+Ar | In+Ce+N+Ti+V+Ar
oficina: O+F+I+C+I+Na
renunciar: Re+N+U+N+C+I+Ar
checo: C+He+C+O | C+He+Co
socialismo: S+O+C+I+Al+I+S+Mo | S+O+C+I+Al+I+Sm+O
activista: Ac+Ti+V+I+S+Ta
crucial: C+Ru+C+I+Al | Cr+U+C+I+Al
recair: Re+Ca+Ir
paraíso: Pa+Ra+I+S+O
cerco: C+Er+Co | C+Er+C+O
pânico: Pa+N+I+Co | Pa+N+I+C+O | Pa+Ni+Co | Pa+Ni+C+O
confuso: C+O+N+F+U+S+O | Co+N+F+U+S+O
prisional: Pr+I+S+I+O+N+Al | Pr+I+Si+O+N+Al
prestes: P+Re+S+Te+S | Pr+Es+Te+S
recuo: Re+Cu+O | Re+C+U+O
parente: Pa+Re+N+Te
Cairo: Ca+Ir+O
lira: Li+Ra
fruta: F+Ru+Ta | Fr+U+Ta
rali: Ra+Li
feita: Fe+I+Ta
escocês: Es+C+O+C+Es | Es+Co+C+Es | Es+Co+Ce+S | Es+C+O+Ce+S
atrever: At+Re+V+Er
indiciar: I+Nd+I+C+I+Ar
bando: Ba+Nd+O
mobiliário: Mo+Bi+Li+Ar+I+O | Mo+B+I+Li+Ar+I+O
clínica: Cl+I+N+I+Ca | Cl+I+Ni+Ca | Cl+In+I+Ca | C+Li+Ni+Ca | C+Li+N+I+Ca
separatista: Se+P+Ar+At+I+S+Ta | Se+Pa+Ra+Ti+S+Ta
bracarense: B+Ra+Ca+Re+N+Se
congênere: C+O+N+Ge+Ne+Re | Co+N+Ge+Ne+Re
arcebispo: Ar+Ce+B+I+S+P+O | Ar+Ce+B+I+S+Po | Ar+Ce+Bi+S+Po | Ar+Ce+Bi+S+P+O
Camões: C+Am+O+Es | Ca+Mo+Es
Líbano: Li+Ba+No | Li+Ba+N+O
batata: Ba+Ta+Ta
Atlântico: At+La+N+Ti+Co | At+La+N+Ti+C+O
rasgar: Ra+Sg+Ar
fita: F+I+Ta
obstante: O+B+S+Ta+N+Te
cláusula: C+La+U+S+U+La | Cl+Au+S+U+La
Atlanta: At+La+N+Ta
hino: H+I+N+O | H+In+O | H+I+No
chover: C+Ho+V+Er | C+H+O+V+Er
cais: Ca+I+S
escravo: Es+C+Ra+V+O
albergar: Al+Be+Rg+Ar
funeral: F+U+N+Er+Al
cassete: Ca+S+Se+Te | C+As+Se+Te
Nato: N+At+O
Renamo: Re+N+Am+O | Re+Na+Mo
severo: Se+V+Er+O
provir: Pr+O+V+Ir
ampliar: Am+P+Li+Ar
clarificar: Cl+Ar+I+F+I+C+Ar
tela: Te+La
lixeira: Li+Xe+I+Ra
capitalismo: Ca+P+I+Ta+Li+Sm+O | Ca+P+I+Ta+Li+S+Mo
alívio: Al+I+V+I+O
findar: F+I+Nd+Ar
natal: N+At+Al
recluso: Re+C+Lu+S+O | Re+Cl+U+S+O
latino: La+Ti+No | La+Ti+N+O
espólio: Es+P+O+Li+O | Es+Po+Li+O
Castela: Ca+S+Te+La | C+As+Te+La
monopólio: Mo+No+P+O+Li+O | Mo+No+Po+Li+O | Mo+N+O+P+O+Li+O | Mo+N+O+Po+Li+O
Carvalhas: C+Ar+V+Al+H+As
Alverca: Al+V+Er+Ca
cura: C+U+Ra | Cu+Ra
Ippar: I+P+P+Ar
Se: Se
paralisar: Pa+Ra+Li+S+Ar | P+Ar+Al+I+S+Ar
pároco: P+Ar+O+Co | P+Ar+O+C+O
ofender: O+Fe+Nd+Er
Pacheco: P+Ac+He+Co | P+Ac+He+C+O | Pa+C+He+C+O | Pa+C+He+Co
naval: Na+V+Al
flagrante: Fl+Ag+Ra+N+Te
vacina: V+Ac+I+Na
ocupante: O+Cu+Pa+N+Te | O+C+U+Pa+N+Te
vocacionar: V+O+C+Ac+I+O+N+Ar | V+O+Ca+C+I+O+N+Ar
finalista: F+I+N+Al+I+S+Ta | F+I+Na+Li+S+Ta | F+In+Al+I+S+Ta
consensual: C+O+N+Se+N+S+U+Al | Co+N+Se+N+S+U+Al
seca: Se+Ca
tc: Tc
licenciar: Li+Ce+N+C+I+Ar
resumo: Re+S+U+Mo
hos: H+Os | H+O+S | Ho+S
feio: Fe+I+O
Unesco: U+N+Es+Co | U+Ne+S+C+O | U+Ne+S+Co | U+N+Es+C+O | U+Ne+Sc+O
criatura: Cr+I+At+U+Ra
camponês: C+Am+Po+N+Es | C+Am+Po+Ne+S | C+Am+P+O+Ne+S | C+Am+P+O+N+Es
câmbio: C+Am+B+I+O | C+Am+Bi+O
aliviar: Al+I+V+I+Ar
órbita: O+Rb+I+Ta
atrativo: At+Ra+Ti+V+O
escrutínio: Es+C+Ru+Ti+N+I+O | Es+Cr+U+Ti+Ni+O | Es+C+Ru+Ti+Ni+O | Es+Cr+U+Ti+N+I+O
gerente: Ge+Re+N+Te
tapar: Ta+P+Ar
bacalhau: Ba+C+Al+H+Au | B+Ac+Al+H+Au
faro: F+Ar+O
finlandês: F+In+La+Nd+Es | F+I+N+La+Nd+Es
noticioso: N+O+Ti+C+I+Os+O | No+Ti+C+I+O+S+O | N+O+Ti+C+I+O+S+O | No+Ti+C+I+Os+O
ficheiro: F+I+C+He+Ir+O
nono: N+O+N+O | No+No | No+N+O | N+O+No
regata: Re+Ga+Ta
racista: Ra+C+I+S+Ta
show: S+Ho+W | S+H+O+W
nacionalismo: Na+C+I+O+N+Al+I+S+Mo | N+Ac+I+O+N+Al+I+S+Mo | N+Ac+I+O+Na+Li+S+Mo | N+Ac+I+O+N+Al+I+Sm+O | N+Ac+I+O+Na+Li+Sm+O | Na+C+I+O+N+Al+I+Sm+O | Na+C+I+O+Na+Li+Sm+O | Na+C+I+O+Na+Li+S+Mo
povoar: Po+V+O+Ar | P+O+V+O+Ar
tático: Ta+Ti+Co | Ta+Ti+C+O
conviver: C+O+N+V+I+V+Er | Co+N+V+I+V+Er
pairar: Pa+Ir+Ar
estatístico: Es+Ta+Ti+S+Ti+Co | Es+Ta+Ti+S+Ti+C+O
inerente: I+Ne+Re+N+Te
pisar: P+I+S+Ar
cautela: Ca+U+Te+La | C+Au+Te+La
punho: P+U+N+H+O | Pu+N+Ho | P+U+N+Ho | Pu+Nh+O | P+U+Nh+O | Pu+N+H+O
volante: V+O+La+N+Te
carecer: Ca+Re+C+Er
foy: F+O+Y
Bissau: Bi+S+S+Au | B+I+S+S+Au
viário: V+I+Ar+I+O
vocal: V+O+C+Al
luso: Lu+S+O
contingente: C+O+N+Ti+N+Ge+N+Te | Co+N+Ti+N+Ge+N+Te
ca: Ca
ibérico: I+B+Er+I+C+O | I+B+Er+I+Co
perverso: P+Er+V+Er+S+O
inclinar: I+N+Cl+In+Ar | I+N+C+Li+N+Ar | In+Cl+In+Ar | In+Cl+I+N+Ar | In+C+Li+N+Ar | I+N+Cl+I+N+Ar
lã: La
captura: Ca+Pt+U+Ra
basco: Ba+Sc+O | Ba+S+Co | B+As+C+O | B+As+Co | Ba+S+C+O
rubrica: Ru+Br+I+Ca
fiar: F+I+Ar
bravo: B+Ra+V+O
Berlusconi: B+Er+Lu+Sc+O+Ni | B+Er+Lu+Sc+O+N+I | B+Er+Lu+S+C+O+Ni | B+Er+Lu+S+C+O+N+I | B+Er+Lu+S+Co+N+I
bárbaro: Ba+Rb+Ar+O | B+Ar+B+Ar+O
sincero: Si+N+C+Er+O | S+I+N+C+Er+O | S+In+C+Er+O
casino: C+As+I+N+O | Ca+S+I+No | Ca+S+I+N+O | Ca+S+In+O | C+As+In+O | Ca+Si+N+O | Ca+Si+No
aspirar: As+P+Ir+Ar
volver: V+O+Lv+Er
sé: Se
lusitano: Lu+Si+Ta+N+O | Lu+S+I+Ta+N+O | Lu+Si+Ta+No | Lu+S+I+Ta+No
Coliseu: C+O+Li+S+Eu | C+O+Li+Se+U | Co+Li+Se+U | Co+Li+S+Eu
sec: Se+C
circo: C+Ir+Co | C+Ir+C+O
sismo: Si+Sm+O | S+I+S+Mo | S+I+Sm+O | Si+S+Mo
pau: P+Au | Pa+U
violino: V+I+O+Li+N+O | V+I+O+Li+No
sofisticar: S+O+F+I+S+Ti+C+Ar
tchetcheno: Tc+He+Tc+He+N+O | Tc+He+Tc+He+No
sobrinho: S+O+Br+I+N+H+O | S+O+Br+In+H+O | S+O+Br+In+Ho | S+O+Br+I+Nh+O | S+O+Br+I+N+Ho
fisco: F+I+S+C+O | F+I+Sc+O | F+I+S+Co
botão: B+O+Ta+O
inverso: I+N+V+Er+S+O | In+V+Er+S+O
cirúrgico: C+Ir+U+Rg+I+Co | C+I+Ru+Rg+I+Co | C+Ir+U+Rg+I+C+O | C+I+Ru+Rg+I+C+O
gênero: Ge+N+Er+O
pátio: P+At+I+O | Pa+Ti+O
valioso: V+Al+I+Os+O | V+Al+I+O+S+O
Balcãs: B+Al+Ca+S | B+Al+C+As
assassinato: As+S+As+S+In+At+O | As+S+As+S+I+N+At+O | As+S+As+Si+N+At+O
cerebral: Ce+Re+Br+Al
nervo: N+Er+V+O
crônico: Cr+O+Ni+Co | Cr+O+Ni+C+O | Cr+O+N+I+Co | Cr+O+N+I+C+O
sopa: S+O+Pa
irônico: Ir+O+Ni+Co | Ir+O+N+I+C+O | Ir+O+Ni+C+O | Ir+O+N+I+Co
soberano: S+O+Be+Ra+N+O | S+O+Be+Ra+No
accionar: Ac+C+I+O+N+Ar
nascente: N+As+Ce+N+Te | Na+S+Ce+N+Te
Rabin: Ra+B+In | Ra+Bi+N | Ra+B+I+N
incendiar: In+Ce+Nd+I+Ar | I+N+Ce+Nd+I+Ar
réplica: Re+P+Li+Ca
Saramago: S+Ar+Am+Ag+O
inundar: I+N+U+Nd+Ar | In+U+Nd+Ar
espanhola: Es+Pa+Nh+O+La | Es+Pa+N+Ho+La | Es+Pa+N+H+O+La
Huambo: H+U+Am+B+O
licenciatura: Li+Ce+N+C+I+At+U+Ra
escusar: Es+Cu+S+Ar | Es+C+U+S+Ar
bicho: B+I+C+Ho | B+I+C+H+O | Bi+C+H+O | Bi+C+Ho
praticante: P+Ra+Ti+Ca+N+Te | Pr+At+I+Ca+N+Te
funcional: F+U+N+C+I+O+N+Al
Fernando: F+Er+Na+Nd+O
Sines: Si+N+Es | S+I+N+Es | S+I+Ne+S | Si+Ne+S | S+In+Es
proteína: Pr+O+Te+I+Na
pescar: P+Es+C+Ar
sírio: S+Ir+I+O
parabéns: Pa+Ra+Be+N+S
betão: Be+Ta+O
cúbico: C+U+Bi+C+O | Cu+B+I+C+O | Cu+Bi+Co | C+U+B+I+Co | C+U+B+I+C+O | Cu+Bi+C+O | Cu+B+I+Co
pioneiro: P+I+O+Ne+Ir+O
capitalista: Ca+P+I+Ta+Li+S+Ta
agrupar: Ag+Ru+P+Ar
acta: Ac+Ta
propício: Pr+O+P+I+C+I+O
fascista: F+As+C+I+S+Ta
pousar: Po+U+S+Ar | P+O+U+S+Ar
preservativo: Pr+Es+Er+V+At+I+V+O | P+Re+S+Er+V+At+I+V+O
bota: B+O+Ta
salvo: S+Al+V+O
narrativo: N+Ar+Ra+Ti+V+O
colapso: C+O+La+P+S+O | Co+La+P+S+O
céptico: Ce+P+Ti+C+O | Ce+Pt+I+Co | Ce+P+Ti+Co | Ce+Pt+I+C+O
forno: F+O+Rn+O
balão: Ba+La+O
belíssimo: Be+Li+S+S+I+Mo | Be+Li+S+Si+Mo
cereal: Ce+Re+Al
ingênuo: I+N+Ge+N+U+O | In+Ge+N+U+O
insucesso: I+N+S+U+Ce+S+S+O | In+S+U+C+Es+S+O | I+N+S+U+C+Es+S+O | In+S+U+Ce+S+S+O
setenta: Se+Te+N+Ta
Chicago: C+H+I+C+Ag+O
cela: Ce+La
soprar: S+O+Pr+Ar
rap: Ra+P
fatura: F+At+U+Ra
espontâneo: Es+Po+N+Ta+Ne+O | Es+P+O+N+Ta+Ne+O
ternura: Te+Rn+U+Ra
politécnico: P+O+Li+Te+Cn+I+C+O | Po+Li+Te+C+Ni+Co | Po+Li+Te+C+N+I+Co | P+O+Li+Te+C+N+I+Co | P+O+Li+Te+C+Ni+C+O | P+O+Li+Te+C+N+I+C+O | Po+Li+Te+Cn+I+C+O | Po+Li+Te+C+Ni+C+O | Po+Li+Te+C+N+I+C+O
estética: Es+Te+Ti+Ca
monarca: Mo+N+Ar+Ca
filiar: F+I+Li+Ar
profeta: Pr+O+Fe+Ta
liceu: Li+Ce+U | Li+C+Eu
brando: B+Ra+Nd+O
cheirar: C+He+Ir+Ar
conciliar: C+O+N+C+I+Li+Ar | Co+N+C+I+Li+Ar
solista: S+O+Li+S+Ta
chiar: C+H+I+Ar
sessenta: Se+S+Se+N+Ta | S+Es+Se+N+Ta
prescindir: Pr+Es+C+I+Nd+Ir | P+Re+S+C+I+Nd+Ir | P+Re+Sc+I+Nd+Ir
solucionar: S+O+Lu+C+I+O+N+Ar
resistente: Re+Si+S+Te+N+Te | Re+S+I+S+Te+N+Te
periférico: P+Er+I+F+Er+I+Co | P+Er+I+F+Er+I+C+O
heróico: H+Er+O+I+Co | H+Er+O+I+C+O
noticiário: No+Ti+C+I+Ar+I+O | N+O+Ti+C+I+Ar+I+O
interferir: I+N+Te+Rf+Er+Ir | In+Te+Rf+Er+Ir
lucrativo: Lu+Cr+At+I+V+O | Lu+C+Ra+Ti+V+O
véu: V+Eu
lacuna: La+Cu+Na | La+C+U+Na
costeiro: Co+S+Te+Ir+O | C+Os+Te+Ir+O | C+O+S+Te+Ir+O
cavalheiro: Ca+V+Al+He+Ir+O
pico: P+I+C+O | P+I+Co
suspirar: S+U+S+P+Ir+Ar
Hitler: H+I+Tl+Er
rechear: Re+C+He+Ar
cativar: Ca+Ti+V+Ar | C+At+I+V+Ar
clamar: Cl+Am+Ar
mote: Mo+Te
recriar: Re+Cr+I+Ar
crente: C+Re+N+Te
óptica: O+Pt+I+Ca | O+P+Ti+Ca
libanês: Li+Ba+Ne+S | Li+Ba+N+Es
soberbo: S+O+B+Er+B+O | S+O+Be+Rb+O
remover: Re+Mo+V+Er
fascismo: F+As+C+I+Sm+O | F+As+C+I+S+Mo
racional: Ra+C+I+O+N+Al
nau: Na+U | N+Au
oitenta: O+I+Te+N+Ta
rapto: Ra+Pt+O
Hamas: H+Am+As
Carnaval: C+Ar+Na+V+Al
carvalho: C+Ar+V+Al+H+O | C+Ar+V+Al+Ho
copiar: Co+P+I+Ar | C+O+P+I+Ar
potente: Po+Te+N+Te | P+O+Te+N+Te
alcoólico: Al+C+O+O+Li+Co | Al+C+O+O+Li+C+O | Al+Co+O+Li+C+O | Al+Co+O+Li+Co
vogal: V+Og+Al
beneficiário: Be+Ne+F+I+C+I+Ar+I+O
fibra: F+I+B+Ra
subúrbio: S+U+B+U+Rb+I+O
verbal: V+Er+B+Al
lapso: La+P+S+O
intensificar: In+Te+N+Si+F+I+C+Ar | I+N+Te+N+Si+F+I+C+Ar | I+N+Te+N+S+I+F+I+C+Ar | In+Te+N+S+I+F+I+C+Ar
sino: S+In+O | Si+No | Si+N+O | S+I+No | S+I+N+O
sufrágio: S+U+Fr+Ag+I+O
artifício: Ar+Ti+F+I+C+I+O
genuíno: Ge+N+U+In+O | Ge+N+U+I+No | Ge+N+U+I+N+O
vigente: V+I+Ge+N+Te
verbo: V+Er+B+O
Ferreira: F+Er+Re+I+Ra
escandaloso: Es+Ca+Nd+Al+O+S+O | Es+Ca+Nd+Al+Os+O
Ovar: O+V+Ar
Cannes: Ca+N+Ne+S | Ca+N+N+Es
incógnita: I+N+C+Og+N+I+Ta | In+C+Og+Ni+Ta | I+N+C+Og+Ni+Ta | In+C+Og+N+I+Ta
notificar: N+O+Ti+F+I+C+Ar | No+Ti+F+I+C+Ar
lata: La+Ta
persistente: P+Er+Si+S+Te+N+Te | P+Er+S+I+S+Te+N+Te
usufruir: U+S+U+Fr+U+Ir | U+S+U+F+Ru+Ir
recreio: Re+C+Re+I+O
sumo: S+U+Mo
acústico: Ac+U+S+Ti+Co | Ac+U+S+Ti+C+O
of: O+F
ciclismo: C+I+C+Li+S+Mo | C+I+C+Li+Sm+O | C+I+Cl+I+Sm+O | C+I+Cl+I+S+Mo
obrigacionista: O+Br+I+Ga+C+I+O+Ni+S+Ta | O+Br+I+Ga+C+I+O+N+I+S+Ta
Inverno: I+N+V+Er+N+O | In+V+Er+No | I+N+V+Er+No | In+V+Er+N+O
concessionário: Co+N+C+Es+Si+O+N+Ar+I+O | C+O+N+Ce+S+Si+O+N+Ar+I+O | Co+N+Ce+S+Si+O+N+Ar+I+O | C+O+N+C+Es+Si+O+N+Ar+I+O | Co+N+C+Es+S+I+O+N+Ar+I+O | C+O+N+C+Es+S+I+O+N+Ar+I+O | C+O+N+Ce+S+S+I+O+N+Ar+I+O
privar: Pr+I+V+Ar
americana: Am+Er+I+Ca+Na
Chirac: C+H+I+Ra+C | C+H+Ir+Ac
pássaro: Pa+S+S+Ar+O | P+As+S+Ar+O
burguês: B+U+Rg+U+Es
Alcântara: Al+Ca+N+Ta+Ra
Fenprof: Fe+N+Pr+O+F
partícula: P+Ar+Ti+Cu+La | P+Ar+Ti+C+U+La
boi: B+O+I
consistente: C+O+N+S+I+S+Te+N+Te | Co+N+S+I+S+Te+N+Te | Co+N+Si+S+Te+N+Te | C+O+N+Si+S+Te+N+Te
repouso: Re+Po+U+S+O | Re+P+O+U+S+O
espancar: Es+Pa+N+C+Ar
itinerário: I+Ti+N+Er+Ar+I+O
freira: F+Re+I+Ra
reparo: Re+P+Ar+O
Feira: Fe+I+Ra
largura: La+Rg+U+Ra
referenciar: Re+Fe+Re+N+C+I+Ar
monge: Mo+N+Ge
stand: S+Ta+Nd
non: N+O+N | No+N
esmola: Es+Mo+La
vocalista: V+O+Ca+Li+S+Ta | V+O+C+Al+I+S+Ta
raciocínio: Ra+C+I+O+C+I+N+I+O | Ra+C+I+O+C+I+Ni+O | Ra+C+I+O+C+In+I+O
raptar: Ra+Pt+Ar
Praga: P+Ra+Ga
albufeira: Al+B+U+Fe+I+Ra
ouvinte: O+U+V+I+N+Te | O+U+V+In+Te
operativo: O+P+Er+At+I+V+O
crónica: Cr+O+N+I+Ca | Cr+O+Ni+Ca
testa: Te+S+Ta
olival: O+Li+V+Al
bico: B+I+C+O | B+I+Co | Bi+Co | Bi+C+O
Rui: Ru+I
Mónaco: Mo+Na+Co | Mo+N+Ac+O | Mo+Na+C+O
lusófono: Lu+S+O+F+O+N+O | Lu+S+O+F+O+No
vaso: V+As+O
parágrafo: P+Ar+Ag+Ra+F+O
renascer: Re+N+As+C+Er | Re+Na+Sc+Er | Re+Na+S+C+Er
naõ: Na+O
realismo: Re+Al+I+S+Mo | Re+Al+I+Sm+O
carbono: Ca+Rb+O+N+O | Ca+Rb+O+No | C+Ar+B+O+N+O | C+Ar+B+O+No
tabu: Ta+B+U
férreo: F+Er+Re+O
fascínio: F+As+C+I+Ni+O | F+As+C+In+I+O | F+As+C+I+N+I+O
ira: I+Ra
genial: Ge+Ni+Al | Ge+N+I+Al
colina: C+O+Li+Na | Co+Li+Na
física: F+I+Si+Ca | F+I+S+I+Ca
castanho: C+As+Ta+N+H+O | Ca+S+Ta+Nh+O | Ca+S+Ta+N+H+O | Ca+S+Ta+N+Ho | C+As+Ta+N+Ho | C+As+Ta+Nh+O
caseiro: Ca+Se+Ir+O
banal: Ba+N+Al
nervosismo: N+Er+V+Os+I+Sm+O | N+Er+V+O+S+I+Sm+O | N+Er+V+O+S+I+S+Mo | N+Er+V+O+Si+S+Mo | N+Er+V+O+Si+Sm+O | N+Er+V+Os+I+S+Mo
balneário: B+Al+Ne+Ar+I+O
pinheiro: P+In+He+Ir+O | P+I+N+He+Ir+O
repousar: Re+P+O+U+S+Ar | Re+Po+U+S+Ar
cerâmica: C+Er+Am+I+Ca
cooperativo: C+O+O+P+Er+At+I+V+O | Co+O+P+Er+At+I+V+O
boneco: B+O+Ne+Co | B+O+Ne+C+O
Nuno: N+U+No | N+U+N+O
cupão: Cu+Pa+O | C+U+Pa+O
Singapura: S+I+N+Ga+P+U+Ra | Si+N+Ga+P+U+Ra | S+In+Ga+P+U+Ra | Si+N+Ga+Pu+Ra | S+I+N+Ga+Pu+Ra | S+In+Ga+Pu+Ra
gala: Ga+La
presenciar: P+Re+Se+N+C+I+Ar
revogar: Re+V+Og+Ar
suspiro: S+U+S+P+Ir+O
fluvial: F+Lu+V+I+Al | Fl+U+V+I+Al
seropositivo: S+Er+O+P+Os+I+Ti+V+O | S+Er+O+Po+S+I+Ti+V+O | S+Er+O+Po+Si+Ti+V+O | S+Er+O+P+O+S+I+Ti+V+O | S+Er+O+P+O+Si+Ti+V+O
oiro: O+Ir+O
caractere: Ca+Ra+C+Te+Re | C+Ar+Ac+Te+Re
alternar: Al+Te+Rn+Ar
recibo: Re+C+I+B+O
processual: Pr+O+C+Es+S+U+Al | Pr+O+Ce+S+S+U+Al
Sec: Se+C
confesso: Co+N+F+Es+S+O | C+O+N+F+Es+S+O | Co+N+Fe+S+S+O | C+O+N+Fe+S+S+O
terapêutico: Te+Ra+P+Eu+Ti+Co | Te+Ra+P+Eu+Ti+C+O
hipotético: H+I+Po+Te+Ti+Co | H+I+Po+Te+Ti+C+O | H+I+P+O+Te+Ti+C+O | H+I+P+O+Te+Ti+Co
cru: C+Ru | Cr+U
Canal: Ca+N+Al
pá: Pa
replicar: Re+P+Li+C+Ar
Peres: P+Er+Es
hoste: Ho+S+Te | H+O+S+Te | H+Os+Te
fascinante: F+As+C+I+Na+N+Te
reivindicativo: Re+I+V+I+Nd+I+Ca+Ti+V+O | Re+I+V+I+Nd+I+C+At+I+V+O
si: Si | S+I
secar: Se+C+Ar
arrasar: Ar+Ra+S+Ar
Chipre: C+H+I+P+Re
filial: F+I+Li+Al
ninho: N+I+N+Ho | N+In+H+O | N+I+Nh+O | N+In+Ho | Ni+N+Ho | Ni+N+H+O | Ni+Nh+O | N+I+N+H+O
fascinar: F+As+C+I+N+Ar | F+As+C+In+Ar
indígena: I+Nd+I+Ge+Na
islão: I+S+La+O
táctica: Ta+C+Ti+Ca
populacional: P+O+Pu+La+C+I+O+N+Al | Po+P+U+La+C+I+O+N+Al | Po+Pu+La+C+I+O+N+Al | P+O+P+U+La+C+I+O+N+Al
pinhal: P+I+Nh+Al | P+In+H+Al | P+I+N+H+Al
benéfico: Be+Ne+F+I+C+O | Be+Ne+F+I+Co
pirata: P+I+Ra+Ta
morno: Mo+Rn+O
cooperar: C+O+O+P+Er+Ar | Co+O+P+Er+Ar
fosso: F+O+S+S+O | F+Os+S+O
tenso: Te+N+S+O
Filipinas: F+I+Li+P+I+N+As | F+I+Li+P+In+As | F+I+Li+P+I+Na+S
escuta: Es+C+U+Ta | Es+Cu+Ta
partes: P+Ar+Te+S
caótico: Ca+O+Ti+C+O | Ca+O+Ti+Co
carinho: C+Ar+I+Nh+O | C+Ar+I+N+H+O | C+Ar+I+N+Ho | C+Ar+In+H+O | C+Ar+In+Ho
Peru: P+Er+U
falir: F+Al+Ir
vertical: V+Er+Ti+C+Al
Mota: Mo+Ta
profissionalismo: Pr+O+F+I+S+Si+O+N+Al+I+S+Mo | Pr+O+F+I+S+Si+O+Na+Li+S+Mo | Pr+O+F+I+S+Si+O+N+Al+I+Sm+O | Pr+O+F+I+S+S+I+O+N+Al+I+Sm+O | Pr+O+F+I+S+Si+O+Na+Li+Sm+O | Pr+O+F+I+S+S+I+O+Na+Li+S+Mo | Pr+O+F+I+S+S+I+O+N+Al+I+S+Mo | Pr+O+F+I+S+S+I+O+Na+Li+Sm+O
cõ: Co | C+O
blues: B+Lu+Es
insinuar: In+S+I+N+U+Ar | I+N+S+I+N+U+Ar | I+N+Si+N+U+Ar | In+Si+N+U+Ar | I+N+S+In+U+Ar | In+S+In+U+Ar
convincente: Co+N+V+In+Ce+N+Te | C+O+N+V+In+Ce+N+Te | C+O+N+V+I+N+Ce+N+Te | Co+N+V+I+N+Ce+N+Te
fronteiro: Fr+O+N+Te+Ir+O
casta: C+As+Ta | Ca+S+Ta
fronte: Fr+O+N+Te
boxe: B+O+Xe
Albufeira: Al+B+U+Fe+I+Ra
cepticismo: Ce+Pt+I+C+I+S+Mo | Ce+P+Ti+C+I+Sm+O | Ce+Pt+I+C+I+Sm+O | Ce+P+Ti+C+I+S+Mo
poluir: Po+Lu+Ir | P+O+Lu+Ir
fracassar: Fr+Ac+As+S+Ar | F+Ra+C+As+S+Ar | F+Ra+Ca+S+S+Ar
Frelimo: F+Re+Li+Mo
patamar: P+At+Am+Ar
viola: V+I+O+La
Este: Es+Te
César: C+Es+Ar | Ce+S+Ar
atar: At+Ar
sopro: S+O+Pr+O
preferencial: P+Re+Fe+Re+N+C+I+Al
chocante: C+H+O+Ca+N+Te | C+Ho+Ca+N+Te
atmosférico: At+Mo+S+F+Er+I+Co | At+Mo+S+F+Er+I+C+O
politicar: P+O+Li+Ti+C+Ar | Po+Li+Ti+C+Ar
erótico: Er+O+Ti+C+O | Er+O+Ti+Co
crônica: Cr+O+N+I+Ca | Cr+O+Ni+Ca
racial: Ra+C+I+Al
clã: C+La
cênico: Ce+Ni+C+O | Ce+Ni+Co | Ce+N+I+Co | Ce+N+I+C+O
capricho: Ca+Pr+I+C+H+O | Ca+Pr+I+C+Ho
noivo: N+O+I+V+O | No+I+V+O
focar: F+O+C+Ar
unificar: U+Ni+F+I+C+Ar | U+N+I+F+I+C+Ar
fundir: F+U+Nd+Ir
coreógrafo: Co+Re+Og+Ra+F+O | C+O+Re+Og+Ra+F+O
naufrágio: Na+U+Fr+Ag+I+O | N+Au+Fr+Ag+I+O
Arsenal: Ar+Se+N+Al
vibrar: V+I+Br+Ar
arraial: Ar+Ra+I+Al
cascar: Ca+Sc+Ar | Ca+S+C+Ar | C+As+C+Ar
Francisco: F+Ra+N+C+I+S+C+O | F+Ra+N+C+I+Sc+O | F+Ra+N+C+I+S+Co
flanco: F+La+N+Co | F+La+N+C+O
frescura: Fr+Es+C+U+Ra | F+Re+S+Cu+Ra | Fr+Es+Cu+Ra | F+Re+S+C+U+Ra | F+Re+Sc+U+Ra
precoce: P+Re+C+O+Ce | P+Re+Co+Ce
caricatura: C+Ar+I+C+At+U+Ra
arsenal: Ar+Se+N+Al
festivo: F+Es+Ti+V+O | Fe+S+Ti+V+O
bovino: B+O+V+I+No | B+O+V+I+N+O | B+O+V+In+O
vincar: V+I+N+C+Ar | V+In+C+Ar
preparativo: P+Re+P+Ar+At+I+V+O | P+Re+Pa+Ra+Ti+V+O
cúpula: C+U+Pu+La | C+U+P+U+La | Cu+P+U+La | Cu+Pu+La
clero: Cl+Er+O
ressalvar: Re+S+S+Al+V+Ar
auge: Au+Ge
contencioso: Co+N+Te+N+C+I+O+S+O | C+O+N+Te+N+C+I+Os+O | Co+N+Te+N+C+I+Os+O | C+O+N+Te+N+C+I+O+S+O
Fretilin: F+Re+Ti+Li+N
pose: P+O+Se | Po+Se
rancho: Ra+N+C+Ho | Ra+N+C+H+O
camioneta: C+Am+I+O+Ne+Ta
Sony: S+O+N+Y
Moita: Mo+I+Ta
livreiro: Li+V+Re+Ir+O
revés: Re+V+Es
carenciar: Ca+Re+N+C+I+Ar
Beira: Be+I+Ra
luar: Lu+Ar
atalhar: At+Al+H+Ar
recta: Re+C+Ta
cantiga: Ca+N+Ti+Ga
Luís: Lu+I+S
Eusébio: Eu+Se+Bi+O | Eu+Se+B+I+O
Basílio: B+As+I+Li+O | Ba+S+I+Li+O | Ba+Si+Li+O
Óscar: Os+C+Ar | O+S+C+Ar | O+Sc+Ar
incondicional: In+C+O+Nd+I+C+I+O+N+Al | In+Co+Nd+I+C+I+O+N+Al | I+N+Co+Nd+I+C+I+O+N+Al | I+N+C+O+Nd+I+C+I+O+N+Al
calibre: C+Al+I+B+Re | Ca+Li+B+Re
sr: Sr
moinho: Mo+I+N+H+O | Mo+In+H+O | Mo+I+Nh+O | Mo+In+Ho | Mo+I+N+Ho
fúnebre: F+U+Ne+B+Re
sufocar: S+U+F+O+C+Ar
Senna: Se+N+Na
site: Si+Te | S+I+Te
ra: Ra
cm: Cm
Tavira: Ta+V+I+Ra
boato: B+O+At+O
cravo: C+Ra+V+O
on: O+N
McLaren: Mc+La+Re+N
cravar: C+Ra+V+Ar
arrebatar: Ar+Re+B+At+Ar
Moura: Mo+U+Ra
Eriksson: Er+I+K+S+S+O+N
áspero: As+P+Er+O
peste: P+Es+Te
óptico: O+P+Ti+Co | O+P+Ti+C+O | O+Pt+I+C+O | O+Pt+I+Co
at: At
estai: Es+Ta+I
usual: U+S+U+Al
espesso: Es+P+Es+S+O
certificar: C+Er+Ti+F+I+C+Ar
camionista: C+Am+I+O+Ni+S+Ta | C+Am+I+O+N+I+S+Ta
hipócrita: H+I+P+O+Cr+I+Ta | H+I+Po+Cr+I+Ta
branca: B+Ra+N+Ca
sinônimo: Si+No+Ni+Mo | S+In+O+N+I+Mo | S+I+N+O+N+I+Mo | S+In+O+Ni+Mo | S+I+N+O+Ni+Mo | Si+No+N+I+Mo | S+I+No+N+I+Mo | Si+N+O+N+I+Mo | Si+N+O+Ni+Mo
urânio: U+Ra+N+I+O | U+Ra+Ni+O
liberalismo: Li+Be+Ra+Li+Sm+O | Li+Be+Ra+Li+S+Mo | Li+B+Er+Al+I+Sm+O | Li+B+Er+Al+I+S+Mo
cabra: Ca+B+Ra
rebanho: Re+Ba+Nh+O | Re+Ba+N+H+O | Re+Ba+N+Ho
Estaline: Es+Ta+Li+Ne
pérola: P+Er+O+La
fragata: F+Ra+Ga+Ta
futebolístico: F+U+Te+B+O+Li+S+Ti+C+O | F+U+Te+B+O+Li+S+Ti+Co
vice: V+I+Ce
seringa: S+Er+In+Ga | S+Er+I+N+Ga
alga: Al+Ga
prognóstico: Pr+Og+No+S+Ti+C+O | Pr+Og+N+O+S+Ti+Co | Pr+Og+N+O+S+Ti+C+O | Pr+Og+N+Os+Ti+C+O | Pr+Og+No+S+Ti+Co
Algés: Al+Ge+S
flauta: Fl+Au+Ta | F+La+U+Ta
cantina: Ca+N+Ti+Na
hindu: H+I+Nd+U
artes: Ar+Te+S
Vasco: V+As+Co | V+As+C+O
suar: S+U+Ar
mosca: Mo+S+Ca
confiscar: C+O+N+F+I+S+C+Ar | Co+N+F+I+S+C+Ar | C+O+N+F+I+Sc+Ar | Co+N+F+I+Sc+Ar
Palestina: P+Al+Es+Ti+Na
paisagístico: Pa+I+S+Ag+I+S+Ti+C+O | Pa+I+S+Ag+I+S+Ti+Co
capita: Ca+P+I+Ta
Amoreiras: Am+O+Re+Ir+As | Am+O+Re+I+Ra+S
Sampras: S+Am+P+Ra+S | S+Am+Pr+As
soprano: S+O+P+Ra+N+O | S+O+P+Ra+No
praga: P+Ra+Ga
balnear: B+Al+Ne+Ar
alusivo: Al+U+Si+V+O | Al+U+S+I+V+O
Como: C+O+Mo | Co+Mo
ambicionar: Am+B+I+C+I+O+N+Ar | Am+Bi+C+I+O+N+Ar
indicativo: I+Nd+I+C+At+I+V+O | I+Nd+I+Ca+Ti+V+O
Amaral: Am+Ar+Al
acatar: Ac+At+Ar
Hamburgo: H+Am+B+U+Rg+O
banhar: Ba+N+H+Ar | Ba+Nh+Ar
posicionar: P+O+Si+C+I+O+N+Ar | P+Os+I+C+I+O+N+Ar | Po+S+I+C+I+O+N+Ar | Po+Si+C+I+O+N+Ar | P+O+S+I+C+I+O+N+Ar
auferir: Au+F+Er+Ir
reprovar: Re+Pr+O+V+Ar
Narciso: N+Ar+C+I+S+O
tirano: Ti+Ra+No | Ti+Ra+N+O
sintético: Si+N+Te+Ti+C+O | S+I+N+Te+Ti+C+O | S+In+Te+Ti+Co | S+In+Te+Ti+C+O | Si+N+Te+Ti+Co | S+I+N+Te+Ti+Co
Org: O+Rg
unionista: U+N+I+O+Ni+S+Ta | U+N+I+O+N+I+S+Ta | U+Ni+O+N+I+S+Ta | U+Ni+O+Ni+S+Ta
terno: Te+Rn+O
super: S+U+P+Er
revolver: Re+V+O+Lv+Er
confinar: C+O+N+F+I+N+Ar | C+O+N+F+In+Ar | Co+N+F+I+N+Ar | Co+N+F+In+Ar
reciclar: Re+C+I+Cl+Ar
besta: Be+S+Ta | B+Es+Ta
britânica: Br+I+Ta+Ni+Ca | Br+I+Ta+N+I+Ca
Vilamoura: V+I+La+Mo+U+Ra
parir: P+Ar+Ir
Blair: B+La+Ir
será: Se+Ra
sitiar: S+I+Ti+Ar | Si+Ti+Ar
Octávio: O+C+Ta+V+I+O
baralhar: B+Ar+Al+H+Ar
resgatar: Re+Sg+At+Ar
infernal: I+N+Fe+Rn+Al | In+Fe+Rn+Al | I+N+F+Er+N+Al | In+F+Er+N+Al
progressista: Pr+Og+Re+S+Si+S+Ta | Pr+Og+Re+S+S+I+S+Ta
pretenso: P+Re+Te+N+S+O
feitio: Fe+I+Ti+O
gay: Ga+Y
vilão: V+I+La+O
Iuran: I+U+Ra+N
insistente: I+N+Si+S+Te+N+Te | In+Si+S+Te+N+Te | In+S+I+S+Te+N+Te | I+N+S+I+S+Te+N+Te
brusco: Br+U+Sc+O | B+Ru+S+Co | B+Ru+S+C+O | B+Ru+Sc+O | Br+U+S+C+O | Br+U+S+Co
servo: S+Er+V+O
Nos: N+Os | No+S | N+O+S
cativo: Ca+Ti+V+O | C+At+I+V+O
laser: La+S+Er
reviver: Re+V+I+V+Er
cabina: Ca+Bi+Na | Ca+B+I+Na
bíblico: B+I+B+Li+C+O | Bi+B+Li+C+O | Bi+B+Li+Co | B+I+B+Li+Co
eucalipto: Eu+C+Al+I+Pt+O | Eu+Ca+Li+Pt+O
praxe: P+Ra+Xe
provincial: Pr+O+V+I+N+C+I+Al | Pr+O+V+In+C+I+Al
assinante: As+S+I+Na+N+Te | As+Si+Na+N+Te
viúvo: V+I+U+V+O
fera: Fe+Ra
Esta: Es+Ta
prefácio: P+Re+F+Ac+I+O
cobre: Co+B+Re | C+O+B+Re
banir: Ba+N+Ir
Hebron: He+Br+O+N
liso: Li+S+O
cavar: Ca+V+Ar
Esopo: Es+O+Po | Es+O+P+O
brindar: Br+I+Nd+Ar
resgate: Re+S+Ga+Te
fauna: F+Au+Na
Alcochete: Al+Co+C+He+Te | Al+C+O+C+He+Te
propiciar: Pr+O+P+I+C+I+Ar
soberana: S+O+Be+Ra+Na
rabo: Ra+B+O
asneira: As+Ne+I+Ra
ambulante: Am+B+U+La+N+Te
pluralismo: P+Lu+Ra+Li+Sm+O | P+Lu+Ra+Li+S+Mo
suprir: S+U+Pr+Ir
Sagres: S+Ag+Re+S
pertinente: P+Er+Ti+Ne+N+Te
intensivo: I+N+Te+N+Si+V+O | In+Te+N+Si+V+O | In+Te+N+S+I+V+O | I+N+Te+N+S+I+V+O
comover: C+O+Mo+V+Er | Co+Mo+V+Er
sóbrio: S+O+Br+I+O
remo: Re+Mo
prover: Pr+O+V+Er
harmonioso: H+Ar+Mo+N+I+Os+O | H+Ar+Mo+Ni+O+S+O | H+Ar+Mo+Ni+Os+O | H+Ar+Mo+N+I+O+S+O
falsificar: F+Al+Si+F+I+C+Ar | F+Al+S+I+F+I+C+Ar
champanhe: C+H+Am+Pa+N+He
Chelas: C+He+La+S
Paula: Pa+U+La | P+Au+La
promocional: Pr+O+Mo+C+I+O+N+Al
sobrevoar: S+O+B+Re+V+O+Ar
latente: La+Te+N+Te
cronista: Cr+O+N+I+S+Ta | Cr+O+Ni+S+Ta
chocolate: C+H+O+Co+La+Te | C+Ho+Co+La+Te | C+H+O+C+O+La+Te | C+Ho+C+O+La+Te
ilibar: I+Li+B+Ar
oficioso: O+F+I+C+I+O+S+O | O+F+I+C+I+Os+O
Sérgio: Se+Rg+I+O
Rey: Re+Y
surf: S+U+Rf
rústico: Ru+S+Ti+C+O | Ru+S+Ti+Co
natalício: N+At+Al+I+C+I+O | Na+Ta+Li+C+I+O
invés: I+N+V+Es | In+V+Es
cimo: C+I+Mo
balcânico: B+Al+Ca+N+I+C+O | B+Al+Ca+Ni+C+O | B+Al+Ca+Ni+Co | B+Al+Ca+N+I+Co
fictício: F+I+C+Ti+C+I+O
aura: Au+Ra
filipino: F+I+Li+P+I+No | F+I+Li+P+I+N+O | F+I+Li+P+In+O
carismático: C+Ar+I+Sm+At+I+Co | C+Ar+I+Sm+At+I+C+O
caricato: C+Ar+I+C+At+O
banana: Ba+Na+Na
superficial: S+U+P+Er+F+I+C+I+Al
populista: Po+P+U+Li+S+Ta | P+O+P+U+Li+S+Ta | P+O+Pu+Li+S+Ta | Po+Pu+Li+S+Ta
condicionante: C+O+Nd+I+C+I+O+Na+N+Te | Co+Nd+I+C+I+O+Na+N+Te
hemofílico: He+Mo+F+I+Li+Co | He+Mo+F+I+Li+C+O
gare: Ga+Re
frenético: F+Re+Ne+Ti+C+O | F+Re+Ne+Ti+Co
próspero: Pr+Os+P+Er+O | Pr+O+S+P+Er+O
patético: Pa+Te+Ti+Co | Pa+Te+Ti+C+O
linho: Li+N+Ho | Li+Nh+O | Li+N+H+O
taliban: Ta+Li+Ba+N
mota: Mo+Ta
rega: Re+Ga
Caraíbas: Ca+Ra+I+B+As | Ca+Ra+I+Ba+S
Cunhal: C+U+N+H+Al | Cu+N+H+Al | Cu+Nh+Al | C+U+Nh+Al
laico: La+I+Co | La+I+C+O
cabecear: Ca+Be+Ce+Ar
casco: Ca+Sc+O | Ca+S+Co | Ca+S+C+O | C+As+Co | C+As+C+O
baterista: B+At+Er+I+S+Ta
repressivo: Re+P+Re+S+S+I+V+O | Re+P+Re+S+Si+V+O | Re+Pr+Es+S+I+V+O | Re+Pr+Es+Si+V+O
Ténis: Te+N+I+S | Te+Ni+S
picar: P+I+C+Ar
ruir: Ru+Ir
centésimo: Ce+N+Te+Si+Mo | Ce+N+Te+S+I+Mo
Beirute: Be+Ir+U+Te | Be+I+Ru+Te
influir: I+N+Fl+U+Ir | I+N+F+Lu+Ir | In+F+Lu+Ir | In+Fl+U+Ir
ratinho: Ra+Ti+Nh+O | Ra+Ti+N+H+O | Ra+Ti+N+Ho
gaio: Ga+I+O
recensear: Re+Ce+N+Se+Ar
votante: V+O+Ta+N+Te
cal: C+Al
tenente: Te+Ne+N+Te
blindar: B+Li+Nd+Ar
espiral: Es+P+Ir+Al
cano: Ca+N+O | Ca+No
Baker: Ba+K+Er
esposo: Es+Po+S+O | Es+P+Os+O | Es+P+O+S+O
raso: Ra+S+O
inibir: I+N+I+B+Ir | In+I+B+Ir | I+Ni+B+Ir
interativo: In+Te+Ra+Ti+V+O | I+N+Te+Ra+Ti+V+O
rubricar: Ru+Br+I+C+Ar
cínico: C+I+Ni+C+O | C+I+Ni+Co | C+I+N+I+Co | C+In+I+Co | C+I+N+I+C+O | C+In+I+C+O
secundar: Se+C+U+Nd+Ar | Se+Cu+Nd+Ar
espessura: Es+P+Es+S+U+Ra
urgir: U+Rg+Ir
campa: C+Am+Pa
boné: B+O+Ne
linear: Li+Ne+Ar
hebraico: He+B+Ra+I+Co | He+B+Ra+I+C+O
Serralves: S+Er+Ra+Lv+Es
op: O+P
Artes: Ar+Te+S
inflamar: I+N+Fl+Am+Ar | In+Fl+Am+Ar
consubstanciar: C+O+N+S+U+B+S+Ta+N+C+I+Ar | Co+N+S+U+B+S+Ta+N+C+I+Ar
assar: As+S+Ar
Picasso: P+I+C+As+S+O | P+I+Ca+S+S+O
receoso: Re+Ce+O+S+O | Re+Ce+Os+O
gabar: Ga+B+Ar
cana: Ca+Na
Ivic: I+V+I+C
seta: Se+Ta
crosse: Cr+O+S+Se | Cr+Os+Se
beligerante: Be+Li+Ge+Ra+N+Te
altivo: Al+Ti+V+O
intestino: In+Te+S+Ti+N+O | In+Te+S+Ti+No | I+N+Te+S+Ti+N+O | I+N+Te+S+Ti+No
atlântico: At+La+N+Ti+Co | At+La+N+Ti+C+O
conceptual: C+O+N+Ce+Pt+U+Al | Co+N+Ce+Pt+U+Al
Tavares: Ta+V+Ar+Es
náutico: N+Au+Ti+C+O | Na+U+Ti+Co | Na+U+Ti+C+O | N+Au+Ti+Co
ocasional: O+Ca+Si+O+N+Al | O+C+As+I+O+N+Al | O+Ca+S+I+O+N+Al
repto: Re+Pt+O
amparar: Am+P+Ar+Ar
sensato: Se+N+S+At+O
arca: Ar+Ca
cota: C+O+Ta | Co+Ta
sinfônico: S+I+N+F+O+N+I+Co | S+I+N+F+O+Ni+C+O | S+In+F+O+Ni+C+O | Si+N+F+O+N+I+C+O | S+In+F+O+N+I+Co | S+I+N+F+O+N+I+C+O | Si+N+F+O+Ni+C+O | S+In+F+O+N+I+C+O | Si+N+F+O+N+I+Co | S+In+F+O+Ni+Co
rubro: Ru+Br+O
propagar: Pr+O+P+Ag+Ar
reatar: Re+At+Ar
vassalo: V+As+S+Al+O
Foi: F+O+I
recreativo: Re+C+Re+At+I+V+O
pioneira: P+I+O+Ne+I+Ra
oásis: O+As+I+S
Bach: B+Ac+H | Ba+C+H
palmo: P+Al+Mo
tecla: Te+C+La
sentenciar: Se+N+Te+N+C+I+Ar
arrefecer: Ar+Re+Fe+C+Er
cobra: C+O+B+Ra | Co+B+Ra
Philips: P+H+I+Li+P+S
parvo: P+Ar+V+O
falcão: F+Al+Ca+O
policiar: Po+Li+C+I+Ar | P+O+Li+C+I+Ar
vinculativo: V+I+N+C+U+La+Ti+V+O | V+In+C+U+La+Ti+V+O | V+In+Cu+La+Ti+V+O | V+I+N+Cu+La+Ti+V+O
cv: C+V
Bruno: Br+U+N+O | B+Ru+N+O | Br+U+No | B+Ru+No
cântico: Ca+N+Ti+C+O | Ca+N+Ti+Co
brio: Br+I+O
pílula: P+I+Lu+La
noites: N+O+I+Te+S | No+I+Te+S
esticar: Es+Ti+C+Ar
volumoso: V+O+Lu+Mo+S+O
Nino: N+In+O | N+I+No | N+I+N+O | Ni+No | Ni+N+O
inofensivo: I+No+Fe+N+Si+V+O | I+No+Fe+N+S+I+V+O | I+N+O+Fe+N+Si+V+O | I+N+O+Fe+N+S+I+V+O | In+O+Fe+N+Si+V+O | In+O+Fe+N+S+I+V+O
Libération: Li+B+Er+At+I+O+N | Li+Be+Ra+Ti+O+N
fecundo: Fe+C+U+Nd+O | Fe+Cu+Nd+O
alta: Al+Ta
pata: Pa+Ta
circunscrever: C+Ir+Cu+N+Sc+Re+V+Er | C+Ir+C+U+N+Sc+Re+V+Er | C+Ir+C+U+N+S+C+Re+V+Er | C+Ir+Cu+N+S+C+Re+V+Er
Amaro: Am+Ar+O
caneta: Ca+Ne+Ta
obrar: O+Br+Ar
ferver: F+Er+V+Er
Aloísio: Al+O+I+Si+O | Al+O+I+S+I+O
Social: S+O+C+I+Al
Baptista: Ba+P+Ti+S+Ta | Ba+Pt+I+S+Ta
ag: Ag
skipper: S+K+I+P+P+Er
forasteiro: F+O+Ra+S+Te+Ir+O
válvula: V+Al+V+U+La
un: U+N
rescindir: Re+Sc+I+Nd+Ir | Re+S+C+I+Nd+Ir
báltico: B+Al+Ti+Co | B+Al+Ti+C+O
esférico: Es+F+Er+I+Co | Es+F+Er+I+C+O
neoliberal: Ne+O+Li+B+Er+Al
taberna: Ta+B+Er+Na
pacato: Pa+C+At+O | P+Ac+At+O
hasta: H+As+Ta
arrepio: Ar+Re+P+I+O
oposicionista: O+P+O+S+I+C+I+O+Ni+S+Ta | O+P+O+S+I+C+I+O+N+I+S+Ta | O+Po+Si+C+I+O+N+I+S+Ta | O+P+O+Si+C+I+O+Ni+S+Ta | O+Po+S+I+C+I+O+Ni+S+Ta | O+P+Os+I+C+I+O+Ni+S+Ta | O+Po+Si+C+I+O+Ni+S+Ta | O+P+Os+I+C+I+O+N+I+S+Ta | O+P+O+Si+C+I+O+N+I+S+Ta | O+Po+S+I+C+I+O+N+I+S+Ta
cinta: C+In+Ta | C+I+N+Ta
escavar: Es+Ca+V+Ar
sugestivo: S+U+Ge+S+Ti+V+O
feiticeiro: Fe+I+Ti+Ce+Ir+O
Tiago: Ti+Ag+O
baptismo: Ba+P+Ti+S+Mo | Ba+Pt+I+Sm+O | Ba+Pt+I+S+Mo | Ba+P+Ti+Sm+O
versar: V+Er+S+Ar
lucrar: Lu+Cr+Ar
alicerce: Al+I+C+Er+Ce
Fernandes: F+Er+Na+Nd+Es
coreográfico: C+O+Re+Og+Ra+F+I+C+O | C+O+Re+Og+Ra+F+I+Co | Co+Re+Og+Ra+F+I+Co | Co+Re+Og+Ra+F+I+C+O
condicional: Co+Nd+I+C+I+O+N+Al | C+O+Nd+I+C+I+O+N+Al
off: O+F+F
western: W+Es+Te+Rn
catolicismo: C+At+O+Li+C+I+Sm+O | C+At+O+Li+C+I+S+Mo
carneiro: C+Ar+Ne+Ir+O
caiar: Ca+I+Ar
Burundi: B+U+Ru+Nd+I
sensual: Se+N+S+U+Al
custear: C+U+S+Te+Ar | Cu+S+Te+Ar
Serpa: S+Er+Pa
balbuciar: B+Al+B+U+C+I+Ar
ás: As
confeccionar: Co+N+Fe+C+C+I+O+N+Ar | C+O+N+Fe+C+C+I+O+N+Ar
cera: Ce+Ra
génese: Ge+Ne+Se
tenebroso: Te+Ne+Br+O+S+O | Te+Ne+Br+Os+O
Assis: As+Si+S | As+S+I+S
Franco: F+Ra+N+C+O | F+Ra+N+Co
chato: C+H+At+O
escalar: Es+C+Al+Ar
associativismo: As+S+O+C+I+At+I+V+I+S+Mo | As+S+O+C+I+At+I+V+I+Sm+O
punk: Pu+N+K | P+U+N+K
cabeceira: Ca+Be+Ce+I+Ra
sátira: S+At+I+Ra
esbater: Es+B+At+Er
ativar: At+I+V+Ar
nocivo: N+O+C+I+V+O | No+C+I+V+O
Cravinho: C+Ra+V+In+H+O | C+Ra+V+I+N+H+O | C+Ra+V+I+N+Ho | C+Ra+V+I+Nh+O | C+Ra+V+In+Ho
reacionário: Re+Ac+I+O+N+Ar+I+O
Óscares: Os+C+Ar+Es | O+S+C+Ar+Es | Os+Ca+Re+S | O+S+Ca+Re+S | O+Sc+Ar+Es
internar: I+N+Te+Rn+Ar | In+Te+Rn+Ar
alho: Al+H+O | Al+Ho
acervo: Ac+Er+V+O
espinho: Es+P+In+H+O | Es+P+I+Nh+O | Es+P+I+N+Ho | Es+P+In+Ho | Es+P+I+N+H+O
certeiro: C+Er+Te+Ir+O
receptivo: Re+Ce+P+Ti+V+O | Re+Ce+Pt+I+V+O
prescrever: P+Re+Sc+Re+V+Er | Pr+Es+C+Re+V+Er | P+Re+S+C+Re+V+Er
pólvora: P+O+Lv+O+Ra | Po+Lv+O+Ra
ressurgir: Re+S+S+U+Rg+Ir
almo: Al+Mo
rebater: Re+B+At+Er
pala: Pa+La
líbio: Li+B+I+O | Li+Bi+O
Fiorentina: F+I+O+Re+N+Ti+Na
Oeste: O+Es+Te
florescer: Fl+O+Re+Sc+Er | Fl+O+Re+S+C+Er
obsessivo: O+B+Se+S+S+I+V+O | O+B+S+Es+Si+V+O | O+B+S+Es+S+I+V+O | O+B+Se+S+Si+V+O
chaminé: C+H+Am+I+Ne
Freitas: F+Re+I+Ta+S
calcanhar: C+Al+Ca+Nh+Ar | C+Al+Ca+N+H+Ar
contabilístico: C+O+N+Ta+B+I+Li+S+Ti+Co | C+O+N+Ta+B+I+Li+S+Ti+C+O | Co+N+Ta+B+I+Li+S+Ti+C+O | C+O+N+Ta+Bi+Li+S+Ti+C+O | Co+N+Ta+Bi+Li+S+Ti+Co | Co+N+Ta+B+I+Li+S+Ti+Co | Co+N+Ta+Bi+Li+S+Ti+C+O
proliferar: Pr+O+Li+F+Er+Ar
átomo: At+O+Mo
retificar: Re+Ti+F+I+C+Ar
Álvaro: Al+V+Ar+O
Nantes: Na+N+Te+S
viciar: V+I+C+I+Ar
incendiário: In+Ce+Nd+I+Ar+I+O | I+N+Ce+Nd+I+Ar+I+O
camarote: C+Am+Ar+O+Te
Chico: C+H+I+C+O | C+H+I+Co
assobiar: As+S+O+Bi+Ar | As+S+O+B+I+Ar
rusga: Ru+S+Ga
crânio: C+Ra+N+I+O | C+Ra+Ni+O
eslavo: Es+La+V+O
realce: Re+Al+Ce
Cáucaso: Ca+U+Ca+S+O | Ca+U+C+As+O | C+Au+C+As+O | C+Au+Ca+S+O
classificativo: Cl+As+S+I+F+I+C+At+I+V+O | C+La+S+S+I+F+I+C+At+I+V+O | C+La+S+S+I+F+I+Ca+Ti+V+O | C+La+S+Si+F+I+C+At+I+V+O | Cl+As+Si+F+I+C+At+I+V+O | Cl+As+S+I+F+I+Ca+Ti+V+O | C+La+S+Si+F+I+Ca+Ti+V+O | Cl+As+Si+F+I+Ca+Ti+V+O
Neno: Ne+N+O | Ne+No
instantâneo: In+S+Ta+N+Ta+Ne+O | I+N+S+Ta+N+Ta+Ne+O
arruinar: Ar+Ru+In+Ar | Ar+Ru+I+N+Ar
violinista: V+I+O+Li+N+I+S+Ta | V+I+O+Li+Ni+S+Ta
revolucionar: Re+V+O+Lu+C+I+O+N+Ar
Capucho: Ca+Pu+C+H+O | Ca+P+U+C+H+O | Ca+P+U+C+Ho | Ca+Pu+C+Ho
fundista: F+U+Nd+I+S+Ta
amo: Am+O
cinismo: C+I+Ni+S+Mo | C+I+Ni+Sm+O | C+I+N+I+S+Mo | C+In+I+S+Mo | C+I+N+I+Sm+O | C+In+I+Sm+O
recíproco: Re+C+I+Pr+O+C+O | Re+C+I+Pr+O+Co
Fiat: F+I+At
estilista: Es+Ti+Li+S+Ta
xenófobo: Xe+N+O+F+O+B+O | Xe+No+F+O+B+O
sondar: S+O+Nd+Ar
bife: B+I+Fe | Bi+Fe
re: Re
francófono: F+Ra+N+Co+F+O+No | F+Ra+N+C+O+F+O+No | F+Ra+N+Co+F+O+N+O | F+Ra+N+C+O+F+O+N+O
áureo: Au+Re+O
sic: Si+C | S+I+C
Timofte: Ti+Mo+F+Te
parco: P+Ar+C+O | P+Ar+Co
Isso: I+S+S+O
aliciar: Al+I+C+I+Ar
tesoureiro: Te+S+O+U+Re+Ir+O
positivar: Po+S+I+Ti+V+Ar | Po+Si+Ti+V+Ar | P+O+S+I+Ti+V+Ar | P+O+Si+Ti+V+Ar | P+Os+I+Ti+V+Ar
Serra: S+Er+Ra
homogêneo: Ho+Mo+Ge+Ne+O | H+O+Mo+Ge+Ne+O
beco: Be+C+O | Be+Co
punhal: P+U+Nh+Al | P+U+N+H+Al | Pu+N+H+Al | Pu+Nh+Al
boneca: B+O+Ne+Ca
barreirense: B+Ar+Re+I+Re+N+Se
pacificar: Pa+C+I+F+I+C+Ar | P+Ac+I+F+I+C+Ar
nicho: Ni+C+H+O | Ni+C+Ho | N+I+C+Ho | N+I+C+H+O
clarão: C+La+Ra+O
cebola: Ce+B+O+La
Cristina: Cr+I+S+Ti+Na
estante: Es+Ta+N+Te
cárcere: C+Ar+Ce+Re
Caparica: Ca+P+Ar+I+Ca
samba: S+Am+Ba
Nature: N+At+U+Re
arrendar: Ar+Re+Nd+Ar
nativo: N+At+I+V+O | Na+Ti+V+O
Inês: I+Ne+S | In+Es | I+N+Es
inflacionista: In+Fl+Ac+I+O+Ni+S+Ta | I+N+Fl+Ac+I+O+Ni+S+Ta | In+Fl+Ac+I+O+N+I+S+Ta | I+N+F+La+C+I+O+Ni+S+Ta | In+F+La+C+I+O+N+I+S+Ta | I+N+F+La+C+I+O+N+I+S+Ta | In+F+La+C+I+O+Ni+S+Ta | I+N+Fl+Ac+I+O+N+I+S+Ta
lápis: La+P+I+S
staff: S+Ta+F+F
rácio: Ra+C+I+O
Fonseca: F+O+N+Se+Ca
sucata: S+U+Ca+Ta
sacar: S+Ac+Ar
uno: U+No | U+N+O
ornar: O+Rn+Ar
infrutífero: I+N+Fr+U+Ti+F+Er+O | I+N+F+Ru+Ti+F+Er+O | In+F+Ru+Ti+F+Er+O | In+Fr+U+Ti+F+Er+O
harmônico: H+Ar+Mo+Ni+C+O | H+Ar+Mo+N+I+C+O | H+Ar+Mo+Ni+Co | H+Ar+Mo+N+I+Co
condicionalismo: Co+Nd+I+C+I+O+N+Al+I+S+Mo | Co+Nd+I+C+I+O+Na+Li+Sm+O | Co+Nd+I+C+I+O+N+Al+I+Sm+O | C+O+Nd+I+C+I+O+N+Al+I+Sm+O | Co+Nd+I+C+I+O+Na+Li+S+Mo | C+O+Nd+I+C+I+O+Na+Li+S+Mo | C+O+Nd+I+C+I+O+N+Al+I+S+Mo
chip: C+H+I+P
cf: Cf | C+F
coser: C+Os+Er | Co+S+Er | C+O+S+Er
concernir: Co+N+C+Er+N+Ir | C+O+N+Ce+Rn+Ir | Co+N+Ce+Rn+Ir | C+O+N+C+Er+N+Ir
opinar: O+P+In+Ar | O+P+I+N+Ar
capote: Ca+P+O+Te | Ca+Po+Te
neta: Ne+Ta
rasteiro: Ra+S+Te+Ir+O
Lula: Lu+La
ícone: I+C+O+Ne | I+Co+Ne
referendar: Re+Fe+Re+Nd+Ar
inerte: I+N+Er+Te | In+Er+Te
ónus: O+N+U+S
alucinante: Al+U+C+I+Na+N+Te
versus: V+Er+S+U+S
pato: P+At+O
supervisionar: S+U+P+Er+V+I+S+I+O+N+Ar | S+U+P+Er+V+I+Si+O+N+Ar
secretismo: Se+C+Re+Ti+S+Mo | Se+C+Re+Ti+Sm+O
pornográfico: P+O+Rn+Og+Ra+F+I+C+O | P+O+Rn+Og+Ra+F+I+Co | Po+Rn+Og+Ra+F+I+Co | Po+Rn+Og+Ra+F+I+C+O
frei: F+Re+I
ermo: Er+Mo
Spínola: S+P+In+O+La | S+P+I+No+La | S+P+I+N+O+La
sinuoso: S+In+U+O+S+O | Si+N+U+Os+O | S+In+U+Os+O | S+I+N+U+Os+O | Si+N+U+O+S+O | S+I+N+U+O+S+O
Internacional: In+Te+Rn+Ac+I+O+N+Al | I+N+Te+Rn+Ac+I+O+N+Al
Bicesse: B+I+Ce+S+Se | Bi+C+Es+Se | B+I+C+Es+Se | Bi+Ce+S+Se
coeso: Co+Es+O | C+O+Es+O
sobra: S+O+B+Ra
funerário: F+U+N+Er+Ar+I+O
carrasco: C+Ar+Ra+S+C+O | C+Ar+Ra+Sc+O | C+Ar+Ra+S+Co
Alice: Al+I+Ce
Teixeira: Te+I+Xe+I+Ra
caverna: Ca+V+Er+Na
bengala: Be+N+Ga+La
cobro: Co+Br+O | C+O+Br+O
escamotear: Es+Ca+Mo+Te+Ar | Es+C+Am+O+Te+Ar
cabine: Ca+B+I+Ne | Ca+Bi+Ne
Inácio: In+Ac+I+O | I+N+Ac+I+O | I+Na+C+I+O
Vicente: V+I+Ce+N+Te
lacônico: La+Co+Ni+Co | La+Co+N+I+Co | La+C+O+N+I+C+O | La+C+O+Ni+C+O | La+Co+N+I+C+O | La+C+O+N+I+Co | La+Co+Ni+C+O
Flores: Fl+O+Re+S
auspício: Au+S+P+I+C+I+O
reinante: Re+I+Na+N+Te
pasmar: Pa+Sm+Ar
lapa: La+Pa
Berta: B+Er+Ta
Warner: W+Ar+N+Er
lavoura: La+V+O+U+Ra
terapêutica: Te+Ra+P+Eu+Ti+Ca
itinerante: I+Ti+Ne+Ra+N+Te
escarlate: Es+C+Ar+La+Te
estafeta: Es+Ta+Fe+Ta
esmorecer: Es+Mo+Re+C+Er
poisar: P+O+I+S+Ar | Po+I+S+Ar
Laura: La+U+Ra
Sócrates: S+O+Cr+At+Es | S+O+C+Ra+Te+S
casca: Ca+S+Ca | C+As+Ca
Sicasal: S+I+C+As+Al | S+I+Ca+S+Al | Si+C+As+Al | Si+Ca+S+Al
frasco: F+Ra+S+C+O | Fr+As+C+O | Fr+As+Co | F+Ra+Sc+O | F+Ra+S+Co
asseverar: As+Se+V+Er+Ar
you: Y+O+U
Wagner: W+Ag+N+Er
rasca: Ra+S+Ca
fM: Fm
feirante: Fe+I+Ra+N+Te
escoar: Es+C+O+Ar | Es+Co+Ar
Banif: Ba+Ni+F | Ba+N+I+F
estereótipo: Es+Te+Re+O+Ti+P+O | Es+Te+Re+O+Ti+Po
obcecar: O+B+Ce+C+Ar
escassear: Es+C+As+Se+Ar | Es+Ca+S+Se+Ar
Carolina: C+Ar+O+Li+Na
Agustina: Ag+U+S+Ti+Na
Tirana: Ti+Ra+Na
al: Al
estaca: Es+Ta+Ca
bonificar: B+O+N+I+F+I+C+Ar | B+O+Ni+F+I+C+Ar
suite: S+U+I+Te
Virgílio: V+I+Rg+I+Li+O
paterno: Pa+Te+Rn+O | P+At+Er+N+O | P+At+Er+No
Lusoponte: Lu+S+O+Po+N+Te | Lu+S+O+P+O+N+Te
atracar: At+Ra+C+Ar
Souselas: S+O+U+Se+La+S
score: Sc+O+Re | S+C+O+Re | S+Co+Re
patentear: Pa+Te+N+Te+Ar
irracional: Ir+Ra+C+I+O+N+Al
parabólico: Pa+Ra+B+O+Li+Co | Pa+Ra+B+O+Li+C+O
chacina: C+H+Ac+I+Na
aluna: Al+U+Na
recruta: Re+Cr+U+Ta | Re+C+Ru+Ta
panela: Pa+Ne+La
tira: Ti+Ra
Srebrenica: S+Re+B+Re+Ni+Ca | S+Re+B+Re+N+I+Ca
onipresente: O+N+I+P+Re+Se+N+Te | O+Ni+P+Re+Se+N+Te
estático: Es+Ta+Ti+Co | Es+Ta+Ti+C+O
recarga: Re+C+Ar+Ga
Agassi: Ag+As+Si | Ag+As+S+I
reconciliar: Re+Co+N+C+I+Li+Ar | Re+C+O+N+C+I+Li+Ar
Moisés: Mo+I+Se+S | Mo+I+S+Es
cratera: C+Ra+Te+Ra
atrapalhar: At+Ra+P+Al+H+Ar
Sp: S+P
sonante: S+O+Na+N+Te
gaffe: Ga+F+Fe
flora: Fl+O+Ra
alcoolismo: Al+Co+O+Li+S+Mo | Al+C+O+O+Li+S+Mo | Al+C+O+O+Li+Sm+O | Al+Co+O+Li+Sm+O
tailandês: Ta+I+La+Nd+Es
cunhal: C+U+N+H+Al | Cu+N+H+Al | Cu+Nh+Al | C+U+Nh+Al
corno: C+O+Rn+O | Co+Rn+O
carioca: C+Ar+I+O+Ca
Sobre: S+O+B+Re
assobio: As+S+O+Bi+O | As+S+O+B+I+O
resvalar: Re+S+V+Al+Ar
nos: N+Os | No+S | N+O+S
bula: B+U+La
Herculano: H+Er+C+U+La+N+O | H+Er+Cu+La+No | H+Er+C+U+La+No | H+Er+Cu+La+N+O
Bayern: Ba+Y+Er+N
pagão: Pa+Ga+O
Canárias: Ca+N+Ar+I+As
Ramos: Ra+Mo+S
montanhoso: Mo+N+Ta+Nh+O+S+O | Mo+N+Ta+N+H+Os+O | Mo+N+Ta+Nh+Os+O | Mo+N+Ta+N+H+O+S+O | Mo+N+Ta+N+Ho+S+O
escurecer: Es+Cu+Re+C+Er | Es+C+U+Re+C+Er
Shamir: S+H+Am+Ir
palacete: Pa+La+Ce+Te
infecioso: In+Fe+C+I+O+S+O | In+Fe+C+I+Os+O | I+N+Fe+C+I+Os+O | I+N+Fe+C+I+O+S+O
obsceno: O+B+S+Ce+N+O | O+B+S+Ce+No
Horácio: Ho+Ra+C+I+O | H+O+Ra+C+I+O
barca: B+Ar+Ca
biográfico: Bi+Og+Ra+F+I+C+O | B+I+Og+Ra+F+I+C+O | Bi+Og+Ra+F+I+Co | B+I+Og+Ra+F+I+Co
pontificar: Po+N+Ti+F+I+C+Ar | P+O+N+Ti+F+I+C+Ar
galante: Ga+La+N+Te
Hussein: H+U+S+Se+In | H+U+S+Se+I+N
vagar: V+Ag+Ar
serrano: S+Er+Ra+No | S+Er+Ra+N+O
Neves: Ne+V+Es
bélico: Be+Li+Co | Be+Li+C+O
sarraceno: S+Ar+Ra+Ce+N+O | S+Ar+Ra+Ce+No
Berna: B+Er+Na
cristalino: Cr+I+S+Ta+Li+N+O | Cr+I+S+Ta+Li+No
vibrante: V+I+B+Ra+N+Te
reverso: Re+V+Er+S+O
camuflar: C+Am+U+Fl+Ar
voga: V+O+Ga
cósmico: C+O+Sm+I+Co | Co+Sm+I+Co | C+O+Sm+I+C+O | Co+Sm+I+C+O
férias: F+Er+I+As
alferes: Al+F+Er+Es | Al+Fe+Re+S
papagaio: Pa+Pa+Ga+I+O
fratura: Fr+At+U+Ra
franciscano: F+Ra+N+C+I+S+Ca+N+O | F+Ra+N+C+I+S+Ca+No
carnaval: C+Ar+Na+V+Al
Pp: P+P
Borges: B+O+Rg+Es
vicioso: V+I+C+I+O+S+O | V+I+C+I+Os+O
prega: P+Re+Ga
sindicalismo: Si+Nd+I+C+Al+I+Sm+O | S+I+Nd+I+C+Al+I+S+Mo | Si+Nd+I+C+Al+I+S+Mo | S+I+Nd+I+Ca+Li+Sm+O | S+I+Nd+I+Ca+Li+S+Mo | S+I+Nd+I+C+Al+I+Sm+O | Si+Nd+I+Ca+Li+S+Mo | Si+Nd+I+Ca+Li+Sm+O
Moreira: Mo+Re+I+Ra
lareira: La+Re+I+Ra
benesse: Be+Ne+S+Se | Be+N+Es+Se
creche: C+Re+C+He
cavaco: Ca+V+Ac+O
indagar: I+Nd+Ag+Ar
alli: Al+Li
Palermo: P+Al+Er+Mo
conclusivo: Co+N+C+Lu+Si+V+O | C+O+N+C+Lu+S+I+V+O | C+O+N+Cl+U+Si+V+O | Co+N+C+Lu+S+I+V+O | C+O+N+Cl+U+S+I+V+O | C+O+N+C+Lu+Si+V+O | Co+N+Cl+U+Si+V+O
homônimo: H+O+Mo+Ni+Mo | H+O+Mo+N+I+Mo | Ho+Mo+N+I+Mo | Ho+Mo+Ni+Mo
incisivo: I+N+C+I+Si+V+O | I+N+C+I+S+I+V+O | In+C+I+S+I+V+O | In+C+I+Si+V+O
sampaísta: S+Am+Pa+I+S+Ta
pay: Pa+Y
Carvalho: C+Ar+V+Al+H+O | C+Ar+V+Al+Ho
acampar: Ac+Am+P+Ar
professar: Pr+O+Fe+S+S+Ar | Pr+O+F+Es+S+Ar
cuspir: C+U+S+P+Ir | Cu+S+P+Ir
recheio: Re+C+He+I+O
cifra: C+I+F+Ra
irrealista: Ir+Re+Al+I+S+Ta
revólver: Re+V+O+Lv+Er
veste: V+Es+Te
Tibete: Ti+Be+Te
Silvino: S+I+Lv+I+N+O | Si+Lv+I+N+O | Si+Lv+I+No | Si+Lv+In+O | S+I+Lv+In+O
cascata: C+As+Ca+Ta | Ca+S+Ca+Ta
Becker: Be+C+K+Er
sobrecarga: S+O+B+Re+C+Ar+Ga
Nunca: N+U+N+Ca
costela: C+Os+Te+La | Co+S+Te+La | C+O+S+Te+La
ingestão: I+N+Ge+S+Ta+O | In+Ge+S+Ta+O
Clara: C+La+Ra
vírgula: V+I+Rg+U+La
crucificar: C+Ru+C+I+F+I+C+Ar | Cr+U+C+I+F+I+C+Ar
bovinos: B+O+V+I+No+S | B+O+V+I+N+Os | B+O+V+In+O+S | B+O+V+I+N+O+S | B+O+V+In+Os
kitsch: K+I+Ts+C+H
Hitchcock: H+I+Tc+H+Co+C+K | H+I+Tc+H+C+O+C+K
brochura: Br+O+C+H+U+Ra
fossar: F+O+S+S+Ar | F+Os+S+Ar
coibir: Co+I+B+Ir | C+O+I+B+Ir
sonata: S+O+Na+Ta
cerne: C+Er+Ne
ofuscar: O+F+U+S+C+Ar | O+F+U+Sc+Ar
sísmico: Si+Sm+I+Co | S+I+Sm+I+Co | Si+Sm+I+C+O | S+I+Sm+I+C+O
visionário: V+I+Si+O+N+Ar+I+O | V+I+S+I+O+N+Ar+I+O
pacifista: P+Ac+I+F+I+S+Ta | Pa+C+I+F+I+S+Ta
censo: Ce+N+S+O
Camarões: C+Am+Ar+O+Es
banhista: Ba+N+H+I+S+Ta | Ba+Nh+I+S+Ta
spa: S+Pa
hu: H+U
fogão: F+O+Ga+O
fluir: Fl+U+Ir | F+Lu+Ir
monta: Mo+N+Ta
cifrar: C+I+Fr+Ar
fero: F+Er+O
Unicer: U+N+I+C+Er | U+Ni+C+Er
pontífice: Po+N+Ti+F+I+Ce | P+O+N+Ti+F+I+Ce
personificar: P+Er+S+O+Ni+F+I+C+Ar | P+Er+S+O+N+I+F+I+C+Ar
Renato: Re+N+At+O
lunar: Lu+N+Ar
Sun: S+U+N
Silves: Si+Lv+Es | S+I+Lv+Es
naufragar: Na+U+Fr+Ag+Ar | N+Au+Fr+Ag+Ar
Bihac: Bi+H+Ac | B+I+H+Ac
reativar: Re+At+I+V+Ar
pipa: P+I+Pa
escandinavo: Es+Ca+Nd+I+Na+V+O
cunho: Cu+N+H+O | C+U+Nh+O | C+U+N+Ho | C+U+N+H+O | Cu+Nh+O | Cu+N+Ho
Bucareste: B+U+C+Ar+Es+Te | B+U+Ca+Re+S+Te
boy: B+O+Y
serenar: Se+Re+N+Ar
sensacional: Se+N+S+Ac+I+O+N+Al
papal: Pa+P+Al
moralista: Mo+Ra+Li+S+Ta
harpa: H+Ar+Pa
Nunes: N+U+Ne+S | N+U+N+Es
errante: Er+Ra+N+Te
Cabral: Ca+Br+Al
Lis: Li+S
farrapo: F+Ar+Ra+P+O | F+Ar+Ra+Po
carpinteiro: C+Ar+P+I+N+Te+Ir+O | C+Ar+P+In+Te+Ir+O
feixe: Fe+I+Xe
escravatura: Es+C+Ra+V+At+U+Ra
barbeiro: B+Ar+Be+Ir+O
clarinete: Cl+Ar+I+Ne+Te
cipriota: C+I+Pr+I+O+Ta
esteira: Es+Te+I+Ra
arrepiar: Ar+Re+P+I+Ar
acolá: Ac+O+La
Insp: In+S+P | I+N+S+P
estival: Es+Ti+V+Al
subversivo: S+U+B+V+Er+Si+V+O | S+U+B+V+Er+S+I+V+O
substantivo: S+U+B+S+Ta+N+Ti+V+O
Barrancos: B+Ar+Ra+N+C+O+S | B+Ar+Ra+N+Co+S | B+Ar+Ra+N+C+Os
teimoso: Te+I+Mo+S+O
ósseo: Os+Se+O | O+S+Se+O
Berger: Be+Rg+Er
hipóteses: H+I+Po+Te+Se+S | H+I+Po+Te+S+Es | H+I+P+O+Te+Se+S | H+I+P+O+Te+S+Es
Repúblico: Re+P+U+B+Li+C+O | Re+Pu+B+Li+C+O | Re+Pu+B+Li+Co | Re+P+U+B+Li+Co
gênio: Ge+N+I+O | Ge+Ni+O
parasita: Pa+Ra+Si+Ta | Pa+Ra+S+I+Ta | P+Ar+As+I+Ta
arcaico: Ar+Ca+I+Co | Ar+Ca+I+C+O
inferir: I+N+F+Er+Ir | In+F+Er+Ir
indisciplina: I+Nd+I+S+C+I+P+Li+Na | I+Nd+I+Sc+I+P+Li+Na
escuteiro: Es+Cu+Te+Ir+O | Es+C+U+Te+Ir+O
suborno: S+U+B+O+Rn+O
hesitante: He+S+I+Ta+N+Te | He+Si+Ta+N+Te | H+Es+I+Ta+N+Te
cantão: Ca+N+Ta+O
vigésimo: V+I+Ge+Si+Mo | V+I+Ge+S+I+Mo
burgo: B+U+Rg+O
Thatcher: Th+At+C+H+Er
Smith: Sm+I+Th
reyno: Re+Y+N+O | Re+Y+No
Pacífico: P+Ac+I+F+I+Co | Pa+C+I+F+I+Co | Pa+C+I+F+I+C+O | P+Ac+I+F+I+C+O
Schengen: Sc+He+N+Ge+N | S+C+He+N+Ge+N
briga: Br+I+Ga
renal: Re+N+Al
Rabat: Ra+B+At
amora: Am+O+Ra
provérbio: Pr+O+V+Er+B+I+O | Pr+O+V+Er+Bi+O
generalista: Ge+Ne+Ra+Li+S+Ta | Ge+N+Er+Al+I+S+Ta
bónus: B+O+N+U+S
pio: P+I+O
Assi: As+Si | As+S+I
furacão: F+U+Ra+Ca+O
pungente: Pu+N+Ge+N+Te | P+U+N+Ge+N+Te
cabal: Ca+B+Al
rasgo: Ra+Sg+O
charco: C+H+Ar+C+O | C+H+Ar+Co
alhear: Al+He+Ar
cosmopolita: C+O+S+Mo+P+O+Li+Ta | Co+S+Mo+Po+Li+Ta | C+O+Sm+O+P+O+Li+Ta | C+O+Sm+O+Po+Li+Ta | Co+Sm+O+P+O+Li+Ta | C+Os+Mo+P+O+Li+Ta | C+O+S+Mo+Po+Li+Ta | Co+S+Mo+P+O+Li+Ta | C+Os+Mo+Po+Li+Ta
copa: Co+Pa | C+O+Pa
Carmo: C+Ar+Mo
ficcional: F+I+C+C+I+O+N+Al
cerâmico: C+Er+Am+I+C+O | C+Er+Am+I+Co
brioso: Br+I+O+S+O | Br+I+Os+O
whisky: W+H+I+S+K+Y
prece: P+Re+Ce
pluralista: P+Lu+Ra+Li+S+Ta
Paneira: Pa+Ne+I+Ra
Flandres: F+La+Nd+Re+S
conferencista: C+O+N+Fe+Re+N+C+I+S+Ta | Co+N+Fe+Re+N+C+I+S+Ta
pauta: P+Au+Ta | Pa+U+Ta
Lacão: La+Ca+O
inchar: In+C+H+Ar | I+N+C+H+Ar
cabana: Ca+Ba+Na
soberba: S+O+B+Er+Ba
polvo: Po+Lv+O | P+O+Lv+O
fiasco: F+I+As+Co | F+I+As+C+O
concessionar: C+O+N+Ce+S+S+I+O+N+Ar | Co+N+C+Es+S+I+O+N+Ar | C+O+N+C+Es+Si+O+N+Ar | C+O+N+C+Es+S+I+O+N+Ar | Co+N+C+Es+Si+O+N+Ar | C+O+N+Ce+S+Si+O+N+Ar | Co+N+Ce+S+Si+O+N+Ar
vértice: V+Er+Ti+Ce
caloiro: C+Al+O+Ir+O
referencial: Re+Fe+Re+N+C+I+Al
estandarte: Es+Ta+Nd+Ar+Te
vintena: V+In+Te+Na | V+I+N+Te+Na
Interfina: In+Te+Rf+I+Na | I+N+Te+Rf+I+Na
surfista: S+U+Rf+I+S+Ta
hiper: H+I+P+Er
carinhoso: C+Ar+In+H+O+S+O | C+Ar+I+N+H+Os+O | C+Ar+I+Nh+O+S+O | C+Ar+In+Ho+S+O | C+Ar+In+H+Os+O | C+Ar+I+N+Ho+S+O | C+Ar+I+N+H+O+S+O | C+Ar+I+Nh+Os+O
privativo: Pr+I+V+At+I+V+O
be: Be
refrescar: Re+F+Re+S+C+Ar | Re+F+Re+Sc+Ar | Re+Fr+Es+C+Ar
sensacionalista: Se+N+S+Ac+I+O+Na+Li+S+Ta | Se+N+S+Ac+I+O+N+Al+I+S+Ta
beato: Be+At+O
reinício: Re+I+N+I+C+I+O | Re+In+I+C+I+O | Re+I+Ni+C+I+O
mola: Mo+La
Lakers: La+K+Er+S
alcatrão: Al+C+At+Ra+O
sulista: S+U+Li+S+Ta
ruga: Ru+Ga
insurgir: I+N+S+U+Rg+Ir | In+S+U+Rg+Ir
assírio: As+S+Ir+I+O
piscar: P+I+Sc+Ar | P+I+S+C+Ar
picante: P+I+Ca+N+Te
prosperar: Pr+O+S+P+Er+Ar | Pr+Os+P+Er+Ar
cubo: C+U+B+O | Cu+B+O
funk: F+U+N+K
concílio: Co+N+C+I+Li+O | C+O+N+C+I+Li+O
Pontapés: P+O+N+Ta+P+Es | Po+N+Ta+P+Es
acarinhar: Ac+Ar+I+Nh+Ar | Ac+Ar+I+N+H+Ar | Ac+Ar+In+H+Ar
náufrago: Na+U+Fr+Ag+O | N+Au+Fr+Ag+O
cismar: C+I+Sm+Ar
Bossi: B+O+S+Si | B+Os+S+I | B+O+S+S+I | B+Os+Si
agreste: Ag+Re+S+Te
Vagos: V+Ag+Os | V+Ag+O+S
utensílio: U+Te+N+S+I+Li+O | U+Te+N+Si+Li+O
suíno: S+U+I+No | S+U+I+N+O | S+U+In+O
brinco: Br+I+N+C+O | Br+In+C+O | Br+I+N+Co | Br+In+Co
vaticinar: V+At+I+C+I+N+Ar | V+At+I+C+In+Ar
heroísmo: H+Er+O+I+Sm+O | H+Er+O+I+S+Mo
cinegético: C+I+Ne+Ge+Ti+C+O | C+I+Ne+Ge+Ti+Co
outeiro: O+U+Te+Ir+O
amaro: Am+Ar+O
Alatas: Al+At+As
sinagoga: Si+N+Ag+O+Ga | S+I+N+Ag+O+Ga | S+In+Ag+O+Ga
papá: Pa+Pa
repúblico: Re+P+U+B+Li+C+O | Re+Pu+B+Li+C+O | Re+Pu+B+Li+Co | Re+P+U+B+Li+Co
Simões: S+I+Mo+Es | Si+Mo+Es
supérfluo: S+U+P+Er+F+Lu+O | S+U+P+Er+Fl+U+O
nuca: N+U+Ca
Nice: Ni+Ce | N+I+Ce
moer: Mo+Er
Alves: Al+V+Es
Tenerife: Te+N+Er+I+Fe
taco: Ta+C+O | Ta+Co
hispânico: H+I+S+Pa+N+I+Co | H+I+S+Pa+N+I+C+O | H+I+S+Pa+Ni+Co | H+I+S+Pa+Ni+C+O
tacho: Ta+C+H+O | Ta+C+Ho
moscovita: Mo+S+Co+V+I+Ta | Mo+Sc+O+V+I+Ta | Mo+S+C+O+V+I+Ta
cear: Ce+Ar
Souness: S+O+U+N+Es+S | S+O+U+Ne+S+S
porão: P+O+Ra+O | Po+Ra+O
Física: F+I+Si+Ca | F+I+S+I+Ca
narciso: N+Ar+C+I+S+O
Viriato: V+Ir+I+At+O
saloio: S+Al+O+I+O
Gaspar: Ga+S+P+Ar
ré: Re
ópio: O+P+I+O
inovar: I+N+O+V+Ar | I+No+V+Ar | In+O+V+Ar
rã: Ra
Knicks: K+N+I+C+K+S | K+Ni+C+K+S
Kasparov: K+As+P+Ar+O+V
inconclusivo: In+C+O+N+C+Lu+S+I+V+O | I+N+Co+N+C+Lu+Si+V+O | I+N+Co+N+C+Lu+S+I+V+O | In+Co+N+C+Lu+S+I+V+O | In+C+O+N+Cl+U+Si+V+O | I+N+Co+N+Cl+U+Si+V+O | In+Co+N+C+Lu+Si+V+O | I+N+C+O+N+C+Lu+S+I+V+O | I+N+C+O+N+Cl+U+Si+V+O | In+Co+N+Cl+U+Si+V+O | In+C+O+N+C+Lu+Si+V+O | I+N+C+O+N+C+Lu+Si+V+O
alagar: Al+Ag+Ar
proteccionismo: Pr+O+Te+C+C+I+O+Ni+Sm+O | Pr+O+Te+C+C+I+O+Ni+S+Mo | Pr+O+Te+C+C+I+O+N+I+Sm+O | Pr+O+Te+C+C+I+O+N+I+S+Mo
naturalista: N+At+U+Ra+Li+S+Ta
Atlantis: At+La+N+Ti+S
aresta: Ar+Es+Ta
campus: C+Am+Pu+S | C+Am+P+U+S
volvo: V+O+Lv+O
intencional: I+N+Te+N+C+I+O+N+Al | In+Te+N+C+I+O+N+Al
circundar: C+Ir+C+U+Nd+Ar | C+Ir+Cu+Nd+Ar
Alpes: Al+P+Es
Coruche: C+O+Ru+C+He | Co+Ru+C+He
uníssono: U+N+I+S+S+O+No | U+Ni+S+S+O+N+O | U+Ni+S+S+O+No | U+N+I+S+S+O+N+O
hipotecar: H+I+P+O+Te+C+Ar | H+I+Po+Te+C+Ar
Constâncio: Co+N+S+Ta+N+C+I+O | C+O+N+S+Ta+N+C+I+O
cálice: Ca+Li+Ce | C+Al+I+Ce
estilístico: Es+Ti+Li+S+Ti+C+O | Es+Ti+Li+S+Ti+Co
Albertina: Al+B+Er+Ti+Na
tática: Ta+Ti+Ca
cíclico: C+I+Cl+I+C+O | C+I+Cl+I+Co | C+I+C+Li+C+O | C+I+C+Li+Co
hastear: H+As+Te+Ar
cola: C+O+La | Co+La
refrão: Re+F+Ra+O
campismo: C+Am+P+I+S+Mo | C+Am+P+I+Sm+O
lindíssimo: Li+Nd+I+S+S+I+Mo | Li+Nd+I+S+Si+Mo
inteirar: In+Te+Ir+Ar | I+N+Te+Ir+Ar
crescendo: Cr+Es+Ce+Nd+O | C+Re+S+Ce+Nd+O
mochila: Mo+C+H+I+La
capucho: Ca+Pu+C+H+O | Ca+P+U+C+H+O | Ca+P+U+C+Ho | Ca+Pu+C+Ho
bibliográfico: Bi+B+Li+Og+Ra+F+I+Co | B+I+B+Li+Og+Ra+F+I+Co | Bi+B+Li+Og+Ra+F+I+C+O | B+I+B+Li+Og+Ra+F+I+C+O
batuta: B+At+U+Ta
rebocar: Re+B+O+C+Ar
tecnocrata: Te+C+N+O+C+Ra+Ta | Te+C+No+C+Ra+Ta | Te+Cn+O+C+Ra+Ta
paternal: Pa+Te+Rn+Al | P+At+Er+N+Al
gentio: Ge+N+Ti+O
fraterno: Fr+At+Er+No | F+Ra+Te+Rn+O | Fr+At+Er+N+O
Branco: B+Ra+N+Co | B+Ra+N+C+O
amore: Am+O+Re
acossar: Ac+Os+S+Ar | Ac+O+S+S+Ar
tibetano: Ti+Be+Ta+N+O | Ti+Be+Ta+No
secreta: Se+C+Re+Ta
Senhora: Se+N+Ho+Ra | Se+N+H+O+Ra | Se+Nh+O+Ra
ganga: Ga+N+Ga
caprichoso: Ca+Pr+I+C+H+O+S+O | Ca+Pr+I+C+H+Os+O | Ca+Pr+I+C+Ho+S+O
parentesco: Pa+Re+N+Te+Sc+O | Pa+Re+N+Te+S+Co | Pa+Re+N+Te+S+C+O
barracão: B+Ar+Ra+Ca+O
rente: Re+N+Te
obus: O+B+U+S
nao: Na+O
inflacionar: In+Fl+Ac+I+O+N+Ar | I+N+F+La+C+I+O+N+Ar | I+N+Fl+Ac+I+O+N+Ar | In+F+La+C+I+O+N+Ar
rabi: Ra+B+I | Ra+Bi
insensato: In+Se+N+S+At+O | I+N+Se+N+S+At+O
espiar: Es+P+I+Ar
sobranceiro: S+O+B+Ra+N+Ce+Ir+O
gaivota: Ga+I+V+O+Ta
convés: C+O+N+V+Es | Co+N+V+Es
pântano: Pa+N+Ta+No | Pa+N+Ta+N+O
hebreu: He+B+Re+U | He+Br+Eu
cápsula: Ca+P+S+U+La
bastão: B+As+Ta+O | Ba+S+Ta+O
refinar: Re+F+I+N+Ar | Re+F+In+Ar
núncio: N+U+N+C+I+O
catalogar: C+At+Al+Og+Ar
salina: S+Al+I+Na
Gana: Ga+Na
bote: B+O+Te
civismo: C+I+V+I+S+Mo | C+I+V+I+Sm+O
Tivoli: Ti+V+O+Li
Catarina: C+At+Ar+I+Na
súplica: S+U+P+Li+Ca
conferenciar: Co+N+Fe+Re+N+C+I+Ar | C+O+N+Fe+Re+N+C+I+Ar
suplicar: S+U+P+Li+C+Ar
refrear: Re+F+Re+Ar
nata: Na+Ta
barrete: B+Ar+Re+Te
prenunciar: P+Re+N+U+N+C+I+Ar
popa: Po+Pa | P+O+Pa
parábola: Pa+Ra+B+O+La
Titanic: Ti+Ta+N+I+C | Ti+Ta+Ni+C
protecionista: Pr+O+Te+C+I+O+Ni+S+Ta | Pr+O+Te+C+I+O+N+I+S+Ta
Sinatra: S+I+N+At+Ra | Si+N+At+Ra | S+In+At+Ra
erário: Er+Ar+I+O
silvar: S+I+Lv+Ar | Si+Lv+Ar
conspirar: C+O+N+S+P+Ir+Ar | Co+N+S+P+Ir+Ar
nafta: Na+F+Ta
Filipovic: F+I+Li+Po+V+I+C | F+I+Li+P+O+V+I+C
ateu: At+Eu
Coppola: C+O+P+P+O+La | Co+P+Po+La | C+O+P+Po+La | Co+P+P+O+La
Saturno: S+At+U+Rn+O
perpassar: P+Er+Pa+S+S+Ar | P+Er+P+As+S+Ar
moreno: Mo+Re+No | Mo+Re+N+O
cowboy: Co+W+B+O+Y | C+O+W+B+O+Y
brandir: B+Ra+Nd+Ir
sam: S+Am
clichê: C+Li+C+He | Cl+I+C+He
renhir: Re+N+H+Ir | Re+Nh+Ir
pernicioso: P+Er+Ni+C+I+Os+O | P+Er+Ni+C+I+O+S+O | P+Er+N+I+C+I+Os+O | P+Er+N+I+C+I+O+S+O
cravinho: C+Ra+V+In+H+O | C+Ra+V+I+N+H+O | C+Ra+V+I+N+Ho | C+Ra+V+I+Nh+O | C+Ra+V+In+Ho
cânone: Ca+No+Ne | Ca+N+O+Ne
novíssimo: N+O+V+I+S+Si+Mo | No+V+I+S+S+I+Mo | N+O+V+I+S+S+I+Mo | No+V+I+S+Si+Mo
inócuo: In+O+Cu+O | I+N+O+Cu+O | I+No+Cu+O | I+N+O+C+U+O | I+No+C+U+O | In+O+C+U+O
aguar: Ag+U+Ar
rateio: Ra+Te+I+O
Índice: I+Nd+I+Ce
gaiola: Ga+I+O+La
canceroso: Ca+N+C+Er+Os+O | Ca+N+C+Er+O+S+O
Porfírio: Po+Rf+Ir+I+O | P+O+Rf+Ir+I+O
Alesi: Al+Es+I
suplício: S+U+P+Li+C+I+O
satírico: S+At+Ir+I+Co | S+At+Ir+I+C+O
sunita: S+U+Ni+Ta | S+U+N+I+Ta
acariciar: Ac+Ar+I+C+I+Ar
pró: Pr+O
Colares: C+O+La+Re+S | Co+La+Re+S
soer: S+O+Er
Reis: Re+I+S
Gestão: Ge+S+Ta+O
prenúncio: P+Re+N+U+N+C+I+O
obviar: O+B+V+I+Ar
Falcão: F+Al+Ca+O
agraciar: Ag+Ra+C+I+Ar
vacinar: V+Ac+I+N+Ar | V+Ac+In+Ar
Rei: Re+I
pasmo: P+As+Mo | Pa+S+Mo | Pa+Sm+O
Eugénio: Eu+Ge+N+I+O | Eu+Ge+Ni+O
Subaru: S+U+Ba+Ru | S+U+B+Ar+U
soco: S+O+C+O | S+O+Co
brandura: B+Ra+Nd+U+Ra
rapina: Ra+P+I+Na
erotismo: Er+O+Ti+S+Mo | Er+O+Ti+Sm+O
Balakov: Ba+La+K+O+V
pós: P+Os | P+O+S | Po+S
psicanálise: P+S+I+Ca+N+Al+I+Se | P+Si+Ca+Na+Li+Se | P+S+I+Ca+Na+Li+Se | P+Si+Ca+N+Al+I+Se
Sofin: S+O+F+I+N | S+O+F+In
renitente: Re+N+I+Te+N+Te | Re+Ni+Te+N+Te
interactivo: In+Te+Ra+C+Ti+V+O | I+N+Te+Ra+C+Ti+V+O
cosmonauta: Co+Sm+O+N+Au+Ta | C+O+Sm+O+N+Au+Ta | Co+S+Mo+Na+U+Ta | C+O+S+Mo+N+Au+Ta | C+O+S+Mo+Na+U+Ta | C+Os+Mo+N+Au+Ta | C+O+Sm+O+Na+U+Ta | C+Os+Mo+Na+U+Ta | Co+S+Mo+N+Au+Ta
refrigerante: Re+Fr+I+Ge+Ra+N+Te
oneroso: O+N+Er+O+S+O | O+N+Er+Os+O
house: Ho+U+Se | H+O+U+Se
galão: Ga+La+O
foice: F+O+I+Ce
oficiar: O+F+I+C+I+Ar
sílaba: Si+La+Ba | S+I+La+Ba
vitalício: V+I+Ta+Li+C+I+O
ocioso: O+C+I+O+S+O | O+C+I+Os+O
Prince: Pr+I+N+Ce | Pr+In+Ce
calcário: C+Al+C+Ar+I+O
Arouca: Ar+O+U+Ca
agravo: Ag+Ra+V+O
obreiro: O+B+Re+Ir+O
sobreiro: S+O+B+Re+Ir+O
amassar: Am+As+S+Ar
ressoar: Re+S+S+O+Ar
Real: Re+Al
precipício: P+Re+C+I+P+I+C+I+O
Paulinho: P+Au+Li+N+Ho | Pa+U+Li+N+H+O | P+Au+Li+N+H+O | Pa+U+Li+Nh+O | P+Au+Li+Nh+O | Pa+U+Li+N+Ho
chassi: C+H+As+S+I | C+H+As+Si
sobrevir: S+O+B+Re+V+Ir
pub: Pu+B | P+U+B
cenoura: Ce+No+U+Ra | Ce+N+O+U+Ra
beliscar: Be+Li+S+C+Ar | Be+Li+Sc+Ar
paulista: P+Au+Li+S+Ta | Pa+U+Li+S+Ta
Papa: Pa+Pa
finar: F+I+N+Ar | F+In+Ar
operático: O+P+Er+At+I+Co | O+P+Er+At+I+C+O
cisne: C+I+S+Ne
arrastão: Ar+Ra+S+Ta+O
Vialonga: V+I+Al+O+N+Ga
sótão: S+O+Ta+O
sesta: S+Es+Ta | Se+S+Ta
Reyno: Re+Y+N+O | Re+Y+No
passarinho: P+As+S+Ar+I+N+H+O | Pa+S+S+Ar+I+N+H+O | Pa+S+S+Ar+In+H+O | P+As+S+Ar+In+Ho | P+As+S+Ar+In+H+O | P+As+S+Ar+I+Nh+O | Pa+S+S+Ar+In+Ho | Pa+S+S+Ar+I+Nh+O | Pa+S+S+Ar+I+N+Ho
Constantino: C+O+N+S+Ta+N+Ti+No | Co+N+S+Ta+N+Ti+No | Co+N+S+Ta+N+Ti+N+O | C+O+N+S+Ta+N+Ti+N+O
escarnecer: Es+C+Ar+Ne+C+Er
Bino: B+In+O | B+I+No | Bi+N+O | B+I+N+O | Bi+No
agasalhar: Ag+As+Al+H+Ar
fermoso: F+Er+Mo+S+O
bus: B+U+S
Balacov: Ba+La+C+O+V | Ba+La+Co+V | B+Al+Ac+O+V
regatear: Re+Ga+Te+Ar
bagageira: Ba+Ga+Ge+I+Ra
américa: Am+Er+I+Ca
próstata: Pr+O+S+Ta+Ta | Pr+Os+Ta+Ta
papar: Pa+P+Ar
olá: O+La
Brown: Br+O+W+N
amparo: Am+P+Ar+O
reescrever: Re+Es+C+Re+V+Er
Camberra: C+Am+B+Er+Ra
candura: Ca+Nd+U+Ra
Indurain: I+Nd+U+Ra+I+N | I+Nd+U+Ra+In
Ulisses: U+Li+S+Se+S | U+Li+S+S+Es
pluvial: P+Lu+V+I+Al
álibi: Al+I+B+I | Al+I+Bi
carteiro: C+Ar+Te+Ir+O
sentinela: Se+N+Ti+Ne+La
sarar: S+Ar+Ar
incenso: I+N+Ce+N+S+O | In+Ce+N+S+O
Teseu: Te+Se+U | Te+S+Eu
Bocage: B+O+Ca+Ge
Amares: Am+Ar+Es
profético: Pr+O+Fe+Ti+C+O | Pr+O+Fe+Ti+Co
Kigali: K+I+Ga+Li
congestionar: C+O+N+Ge+S+Ti+O+N+Ar | Co+N+Ge+S+Ti+O+N+Ar
checa: C+He+Ca
Carla: C+Ar+La
tesoura: Te+S+O+U+Ra
sirene: S+I+Re+Ne | Si+Re+Ne
presentear: P+Re+Se+N+Te+Ar
carnavalesco: C+Ar+Na+V+Al+Es+Co | C+Ar+Na+V+Al+Es+C+O
presépio: P+Re+Se+P+I+O
estancar: Es+Ta+N+C+Ar
taõ: Ta+O
Karoglan: K+Ar+Og+La+N
colunista: Co+Lu+Ni+S+Ta | Co+Lu+N+I+S+Ta | C+O+Lu+N+I+S+Ta | C+O+Lu+Ni+S+Ta
Báltico: B+Al+Ti+Co | B+Al+Ti+C+O
aspirante: As+P+I+Ra+N+Te
salpicar: S+Al+P+I+C+Ar
new: Ne+W
bunker: B+U+N+K+Er
SuperSonics: S+U+P+Er+S+O+N+I+C+S | S+U+P+Er+S+O+N+I+Cs | S+U+P+Er+S+O+Ni+Cs | S+U+P+Er+S+O+Ni+C+S
pág: P+Ag
Esp: Es+P
Che: C+He
soalho: S+O+Al+Ho | S+O+Al+H+O
reticente: Re+Ti+Ce+N+Te
planificar: P+La+N+I+F+I+C+Ar | P+La+Ni+F+I+C+Ar
tasca: Ta+S+Ca
hp: H+P
filão: F+I+La+O
farpa: F+Ar+Pa
sueste: S+U+Es+Te
Ericeira: Er+I+Ce+I+Ra
baluarte: Ba+Lu+Ar+Te | B+Al+U+Ar+Te
sina: S+I+Na | Si+Na
Isaltino: I+S+Al+Ti+N+O | I+S+Al+Ti+No
careca: Ca+Re+Ca
vitela: V+I+Te+La
irreal: Ir+Re+Al
hipoteca: H+I+P+O+Te+Ca | H+I+Po+Te+Ca
geopolítico: Ge+O+Po+Li+Ti+C+O | Ge+O+Po+Li+Ti+Co | Ge+O+P+O+Li+Ti+Co | Ge+O+P+O+Li+Ti+C+O
Chopin: C+H+O+P+In | C+H+O+P+I+N | C+Ho+P+In | C+Ho+P+I+N
pregão: P+Re+Ga+O
regente: Re+Ge+N+Te
sarcasmo: S+Ar+Ca+S+Mo | S+Ar+C+As+Mo | S+Ar+Ca+Sm+O
Cohen: Co+He+N | C+O+He+N
artífice: Ar+Ti+F+I+Ce
bei: Be+I
agostinho: Ag+O+S+Ti+N+H+O | Ag+O+S+Ti+N+Ho | Ag+Os+Ti+Nh+O | Ag+Os+Ti+N+H+O | Ag+Os+Ti+N+Ho | Ag+O+S+Ti+Nh+O
referendário: Re+Fe+Re+Nd+Ar+I+O
raiar: Ra+I+Ar
ocasionar: O+C+As+I+O+N+Ar | O+Ca+S+I+O+N+Ar | O+Ca+Si+O+N+Ar
cioso: C+I+Os+O | C+I+O+S+O
er: Er
visionar: V+I+S+I+O+N+Ar | V+I+Si+O+N+Ar
sogra: S+Og+Ra
Sam: S+Am
pa: Pa
bio: B+I+O | Bi+O
Ars: Ar+S
pataca: Pa+Ta+Ca
obeso: O+B+Es+O | O+Be+S+O
fr: Fr
reiniciar: Re+I+Ni+C+I+Ar | Re+I+N+I+C+I+Ar | Re+In+I+C+I+Ar
coca: Co+Ca | C+O+Ca
Agora: Ag+O+Ra
populismo: Po+Pu+Li+S+Mo | Po+P+U+Li+S+Mo | P+O+Pu+Li+S+Mo | P+O+P+U+Li+S+Mo | Po+P+U+Li+Sm+O | P+O+P+U+Li+Sm+O | Po+Pu+Li+Sm+O
hegemônico: He+Ge+Mo+N+I+Co | He+Ge+Mo+Ni+Co | He+Ge+Mo+Ni+C+O | He+Ge+Mo+N+I+C+O
fissura: F+I+S+S+U+Ra
cerimonial: C+Er+I+Mo+N+I+Al | C+Er+I+Mo+Ni+Al
oco: O+Co | O+C+O
espinhoso: Es+P+In+H+O+S+O | Es+P+I+Nh+Os+O | Es+P+I+N+Ho+S+O | Es+P+I+Nh+O+S+O | Es+P+I+N+H+O+S+O | Es+P+In+Ho+S+O | Es+P+I+N+H+Os+O | Es+P+In+H+Os+O
biógrafo: Bi+Og+Ra+F+O | B+I+Og+Ra+F+O
prótese: Pr+O+Te+Se
Ivkovic: I+V+K+O+V+I+C
calcar: C+Al+C+Ar
rachar: Ra+C+H+Ar
vampiro: V+Am+P+Ir+O
rai: Ra+I
famalicense: F+Am+Al+I+Ce+N+Se
Al: Al
Platão: P+La+Ta+O
Nairobi: Na+Ir+O+B+I | Na+Ir+O+Bi
canela: Ca+Ne+La
Inapa: I+Na+Pa
techno: Te+C+H+No | Te+C+H+N+O
catecismo: Ca+Te+C+I+S+Mo | Ca+Te+C+I+Sm+O
baú: Ba+U | B+Au
garante: Ga+Ra+N+Te
Pristina: Pr+I+S+Ti+Na
sui: S+U+I
pára: Pa+Ra
percussionista: P+Er+C+U+S+S+I+O+N+I+S+Ta | P+Er+Cu+S+S+I+O+N+I+S+Ta | P+Er+C+U+S+Si+O+Ni+S+Ta | P+Er+Cu+S+Si+O+Ni+S+Ta | P+Er+C+U+S+Si+O+N+I+S+Ta | P+Er+Cu+S+S+I+O+Ni+S+Ta | P+Er+Cu+S+Si+O+N+I+S+Ta | P+Er+C+U+S+S+I+O+Ni+S+Ta
participativo: P+Ar+Ti+C+I+Pa+Ti+V+O | P+Ar+Ti+C+I+P+At+I+V+O
banheira: Ba+N+He+I+Ra
serão: Se+Ra+O
lacrimogéneo: La+Cr+I+Mo+Ge+Ne+O
chicote: C+H+I+Co+Te | C+H+I+C+O+Te
Baucau: B+Au+C+Au | Ba+U+Ca+U | Ba+U+C+Au | B+Au+Ca+U
posar: Po+S+Ar | P+Os+Ar | P+O+S+Ar
nora: N+O+Ra | No+Ra
feirense: Fe+I+Re+N+Se
paga: Pa+Ga
oval: O+V+Al
caixeiro: Ca+I+Xe+Ir+O
Alcanena: Al+Ca+Ne+Na
puta: P+U+Ta | Pu+Ta
nicotina: Ni+C+O+Ti+Na | N+I+C+O+Ti+Na | N+I+Co+Ti+Na | Ni+Co+Ti+Na
Candal: Ca+Nd+Al
Nacional: Na+C+I+O+N+Al | N+Ac+I+O+N+Al
beirão: Be+I+Ra+O
subalterno: S+U+B+Al+Te+Rn+O
prognosticar: Pr+Og+N+O+S+Ti+C+Ar | Pr+Og+No+S+Ti+C+Ar | Pr+Og+N+Os+Ti+C+Ar
posta: Po+S+Ta | P+Os+Ta | P+O+S+Ta
carnificina: C+Ar+Ni+F+I+C+I+Na | Ca+Rn+I+F+I+C+I+Na | C+Ar+N+I+F+I+C+I+Na
psicanalista: P+S+I+Ca+N+Al+I+S+Ta | P+S+I+Ca+Na+Li+S+Ta | P+Si+Ca+N+Al+I+S+Ta | P+Si+Ca+Na+Li+S+Ta
Gerês: Ge+Re+S
Cruyff: C+Ru+Y+F+F | Cr+U+Y+F+F
cos: Co+S | C+Os | C+O+S
Beiras: Be+Ir+As | Be+I+Ra+S
esticão: Es+Ti+Ca+O
Soure: S+O+U+Re
Recer: Re+C+Er
Crónica: Cr+O+N+I+Ca | Cr+O+Ni+Ca
Corão: Co+Ra+O | C+O+Ra+O
rapper: Ra+P+P+Er
opaco: O+P+Ac+O | O+Pa+Co | O+Pa+C+O
cêntimo: Ce+N+Ti+Mo
réis: Re+I+S
Genscher: Ge+N+S+C+H+Er | Ge+N+Sc+H+Er
renascentista: Re+N+As+Ce+N+Ti+S+Ta | Re+Na+S+Ce+N+Ti+S+Ta
cenógrafo: Ce+N+Og+Ra+F+O
band: Ba+Nd
ruivo: Ru+I+V+O
Fra: F+Ra
propalar: Pr+O+P+Al+Ar
intestinal: In+Te+S+Ti+N+Al | I+N+Te+S+Ti+N+Al
chatice: C+H+At+I+Ce
calvário: C+Al+V+Ar+I+O | Ca+Lv+Ar+I+O
esfriar: Es+Fr+I+Ar
chuvoso: C+H+U+V+Os+O | C+H+U+V+O+S+O
castanheiro: Ca+S+Ta+N+He+Ir+O | C+As+Ta+N+He+Ir+O
artefato: Ar+Te+F+At+O
relance: Re+La+N+Ce
Campos: C+Am+Po+S | C+Am+P+O+S | C+Am+P+Os
arcar: Ar+C+Ar
timoneiro: Ti+Mo+Ne+Ir+O
Reno: Re+No | Re+N+O
Pescas: P+Es+C+As | P+Es+Ca+S
punitivo: Pu+Ni+Ti+V+O | Pu+N+I+Ti+V+O | P+U+N+I+Ti+V+O | P+U+Ni+Ti+V+O
proverbial: Pr+O+V+Er+Bi+Al | Pr+O+V+Er+B+I+Al
Morais: Mo+Ra+I+S
herege: He+Re+Ge
botica: B+O+Ti+Ca
secessionista: Se+Ce+S+S+I+O+N+I+S+Ta | Se+C+Es+S+I+O+Ni+S+Ta | Se+Ce+S+S+I+O+Ni+S+Ta | Se+C+Es+S+I+O+N+I+S+Ta | Se+Ce+S+Si+O+N+I+S+Ta | Se+Ce+S+Si+O+Ni+S+Ta | Se+C+Es+Si+O+N+I+S+Ta | Se+C+Es+Si+O+Ni+S+Ta
lacaio: La+Ca+I+O
cancerígeno: Ca+N+C+Er+I+Ge+N+O | Ca+N+C+Er+I+Ge+No
articulista: Ar+Ti+Cu+Li+S+Ta | Ar+Ti+C+U+Li+S+Ta
aligeirar: Al+I+Ge+Ir+Ar
hepatite: He+P+At+I+Te | He+Pa+Ti+Te
récita: Re+C+I+Ta
Inag: In+Ag | I+N+Ag
pinho: P+In+Ho | P+I+N+H+O | P+I+N+Ho | P+In+H+O | P+I+Nh+O
onírico: O+N+Ir+I+C+O | O+N+Ir+I+Co
canônico: Ca+No+Ni+Co | Ca+N+O+Ni+C+O | Ca+N+O+N+I+C+O | Ca+No+N+I+Co | Ca+N+O+N+I+Co | Ca+No+N+I+C+O | Ca+No+Ni+C+O
Buraca: B+U+Ra+Ca
bica: Bi+Ca | B+I+Ca
Arte: Ar+Te
vácuo: V+Ac+U+O
sertão: S+Er+Ta+O
escalonar: Es+C+Al+O+N+Ar
ers: Er+S
ostensivo: O+S+Te+N+S+I+V+O | Os+Te+N+Si+V+O | Os+Te+N+S+I+V+O | O+S+Te+N+Si+V+O
estacar: Es+Ta+C+Ar
Tbilissi: Tb+I+Li+S+Si | Tb+I+Li+S+S+I
classicismo: Cl+As+Si+C+I+Sm+O | C+La+S+Si+C+I+S+Mo | C+La+S+Si+C+I+Sm+O | Cl+As+S+I+C+I+Sm+O | C+La+S+S+I+C+I+Sm+O | C+La+S+S+I+C+I+S+Mo | Cl+As+S+I+C+I+S+Mo | Cl+As+Si+C+I+S+Mo
casual: C+As+U+Al | Ca+S+U+Al
Panduru: Pa+Nd+U+Ru
Suns: S+U+N+S
cosmos: C+O+S+Mo+S | Co+Sm+O+S | C+O+Sm+Os | C+Os+Mo+S | Co+S+Mo+S | C+O+Sm+O+S | Co+Sm+Os
asno: As+N+O | As+No
vinagre: V+I+N+Ag+Re | V+In+Ag+Re
cancioneiro: Ca+N+C+I+O+Ne+Ir+O
brancura: B+Ra+N+Cu+Ra | B+Ra+N+C+U+Ra
ruinoso: Ru+I+N+O+S+O | Ru+I+No+S+O | Ru+In+O+S+O | Ru+I+N+Os+O | Ru+In+Os+O
rebate: Re+Ba+Te
profundar: Pr+O+F+U+Nd+Ar
conducente: C+O+Nd+U+Ce+N+Te | Co+Nd+U+Ce+N+Te
Sina: S+I+Na | Si+Na
canteiro: Ca+N+Te+Ir+O
sola: S+O+La
palavrão: Pa+La+V+Ra+O
ni: N+I | Ni
boîte: B+O+I+Te
viral: V+Ir+Al
Ruy: Ru+Y
cocheiro: C+O+C+He+Ir+O | Co+C+He+Ir+O
Beirolas: Be+Ir+O+La+S
Vouga: V+O+U+Ga
Cinearte: C+I+Ne+Ar+Te
carapau: Ca+Ra+Pa+U | Ca+Ra+P+Au
neoliberalismo: Ne+O+Li+B+Er+Al+I+S+Mo | Ne+O+Li+B+Er+Al+I+Sm+O | Ne+O+Li+Be+Ra+Li+Sm+O | Ne+O+Li+Be+Ra+Li+S+Mo
líbero: Li+B+Er+O
Inesc: I+Ne+S+C | I+N+Es+C | I+Ne+Sc | In+Es+C
luneta: Lu+Ne+Ta
Ceuta: C+Eu+Ta | Ce+U+Ta
cancela: Ca+N+Ce+La
Spa: S+Pa
Panathinaikos: Pa+N+At+H+I+Na+I+K+Os | Pa+Na+Th+I+Na+I+K+Os | Pa+N+At+H+I+Na+I+K+O+S | Pa+Na+Th+I+Na+I+K+O+S
escárnio: Es+C+Ar+N+I+O | Es+Ca+Rn+I+O | Es+C+Ar+Ni+O
proscrever: Pr+O+Sc+Re+V+Er | Pr+O+S+C+Re+V+Er | Pr+Os+C+Re+V+Er
espreita: Es+P+Re+I+Ta
assessora: As+S+Es+S+O+Ra | As+Se+S+S+O+Ra
Lucas: Lu+Ca+S | Lu+C+As
instintivo: In+S+Ti+N+Ti+V+O | I+N+S+Ti+N+Ti+V+O
Unicef: U+N+I+Ce+F | U+Ni+Ce+F
supranacional: S+U+P+Ra+N+Ac+I+O+N+Al | S+U+P+Ra+Na+C+I+O+N+Al
proponente: Pr+O+P+O+Ne+N+Te | Pr+O+Po+Ne+N+Te
Papandreou: Pa+Pa+Nd+Re+O+U
auspicioso: Au+S+P+I+C+I+O+S+O | Au+S+P+I+C+I+Os+O
Vip: V+I+P
Latapy: La+Ta+P+Y
espoliar: Es+P+O+Li+Ar | Es+Po+Li+Ar
cáustico: Ca+U+S+Ti+C+O | C+Au+S+Ti+C+O | Ca+U+S+Ti+Co | C+Au+S+Ti+Co
cacho: C+Ac+Ho | Ca+C+Ho | Ca+C+H+O | C+Ac+H+O
bravura: B+Ra+V+U+Ra
separatismo: Se+Pa+Ra+Ti+S+Mo | Se+P+Ar+At+I+Sm+O | Se+P+Ar+At+I+S+Mo | Se+Pa+Ra+Ti+Sm+O
estalinista: Es+Ta+Li+Ni+S+Ta | Es+Ta+Li+N+I+S+Ta
Esse: Es+Se
coche: Co+C+He | C+O+C+He
vagaroso: V+Ag+Ar+Os+O | V+Ag+Ar+O+S+O
by: B+Y
aly: Al+Y
Virgin: V+I+Rg+I+N | V+I+Rg+In
pestana: P+Es+Ta+Na
falho: F+Al+Ho | F+Al+H+O
bata: Ba+Ta
soarista: S+O+Ar+I+S+Ta
índico: I+Nd+I+C+O | I+Nd+I+Co
Indesp: I+Nd+Es+P
Bogotá: B+Og+O+Ta
secura: Se+C+U+Ra | Se+Cu+Ra
rey: Re+Y
reposteiro: Re+Po+S+Te+Ir+O | Re+P+O+S+Te+Ir+O | Re+P+Os+Te+Ir+O
ciar: C+I+Ar
berlinense: B+Er+Li+Ne+N+Se
bailundo: Ba+I+Lu+Nd+O
napolitano: Na+Po+Li+Ta+N+O | Na+P+O+Li+Ta+No | Na+Po+Li+Ta+No | Na+P+O+Li+Ta+N+O
circunstancial: C+Ir+Cu+N+S+Ta+N+C+I+Al | C+Ir+C+U+N+S+Ta+N+C+I+Al
cansativo: Ca+N+S+At+I+V+O
generis: Ge+N+Er+I+S
caluniar: Ca+Lu+N+I+Ar | Ca+Lu+Ni+Ar | C+Al+U+Ni+Ar | C+Al+U+N+I+Ar
basílica: Ba+S+I+Li+Ca | Ba+Si+Li+Ca | B+As+I+Li+Ca
aspa: As+Pa
ne: Ne
France: F+Ra+N+Ce
fervura: F+Er+V+U+Ra
aspirina: As+P+Ir+I+Na
tirando: Ti+Ra+Nd+O
sarcástico: S+Ar+Ca+S+Ti+C+O | S+Ar+C+As+Ti+Co | S+Ar+C+As+Ti+C+O | S+Ar+Ca+S+Ti+Co
prepotente: P+Re+Po+Te+N+Te | P+Re+P+O+Te+N+Te
consentâneo: Co+N+Se+N+Ta+Ne+O | C+O+N+Se+N+Ta+Ne+O
coreografar: Co+Re+Og+Ra+F+Ar | C+O+Re+Og+Ra+F+Ar
cálcio: C+Al+C+I+O
Nampula: N+Am+P+U+La | N+Am+Pu+La
Garantias: Ga+Ra+N+Ti+As
freio: F+Re+I+O
Belas: Be+La+S
batalhar: B+At+Al+H+Ar
sionista: Si+O+N+I+S+Ta | S+I+O+N+I+S+Ta | Si+O+Ni+S+Ta | S+I+O+Ni+S+Ta
Recife: Re+C+I+Fe
confluir: C+O+N+F+Lu+Ir | Co+N+F+Lu+Ir | C+O+N+Fl+U+Ir | Co+N+Fl+U+Ir
baila: Ba+I+La
sarau: S+Ar+Au
Paranhos: Pa+Ra+N+Ho+S | Pa+Ra+N+H+O+S | Pa+Ra+N+H+Os | Pa+Ra+Nh+Os | Pa+Ra+Nh+O+S
Nintendo: Ni+N+Te+Nd+O | N+I+N+Te+Nd+O | N+In+Te+Nd+O
coercivo: Co+Er+C+I+V+O | C+O+Er+C+I+V+O
au: Au
relutante: Re+Lu+Ta+N+Te
passional: P+As+Si+O+N+Al | Pa+S+Si+O+N+Al | Pa+S+S+I+O+N+Al | P+As+S+I+O+N+Al
parafrasear: Pa+Ra+F+Ra+Se+Ar
Está: Es+Ta
pomo: P+O+Mo | Po+Mo
crista: Cr+I+S+Ta
clip: C+Li+P | Cl+I+P
homo: H+O+Mo | Ho+Mo
crispar: Cr+I+S+P+Ar
clone: Cl+O+Ne
boiar: B+O+I+Ar
linga: Li+N+Ga
line: Li+Ne
haste: H+As+Te
fulano: F+U+La+No | F+U+La+N+O
falsear: F+Al+Se+Ar
escarpa: Es+C+Ar+Pa
browser: Br+O+W+S+Er
pontão: P+O+N+Ta+O | Po+N+Ta+O
invólucro: In+V+O+Lu+Cr+O | I+N+V+O+Lu+Cr+O
gabão: Ga+Ba+O
internato: I+N+Te+Rn+At+O | In+Te+Rn+At+O
clareira: C+La+Re+I+Ra
repescar: Re+P+Es+C+Ar
parêntesis: Pa+Re+N+Te+S+I+S | Pa+Re+N+Te+Si+S
ócio: O+C+I+O
Botafogo: B+O+Ta+F+Og+O
gata: Ga+Ta
estafar: Es+Ta+F+Ar
ocaso: O+Ca+S+O | O+C+As+O
Caracas: C+Ar+Ac+As | Ca+Ra+Ca+S | Ca+Ra+C+As
Visconti: V+I+S+C+O+N+Ti | V+I+Sc+O+N+Ti | V+I+S+Co+N+Ti
calvo: Ca+Lv+O | C+Al+V+O
Bari: B+Ar+I
vassoura: V+As+S+O+U+Ra
Parker: P+Ar+K+Er
nevar: Ne+V+Ar
hi: H+I
pote: P+O+Te | Po+Te
estio: Es+Ti+O
with: W+I+Th
perca: P+Er+Ca
bluff: B+Lu+F+F
Agostinho: Ag+O+S+Ti+N+H+O | Ag+O+S+Ti+N+Ho | Ag+Os+Ti+Nh+O | Ag+Os+Ti+N+H+O | Ag+Os+Ti+N+Ho | Ag+O+S+Ti+Nh+O
Pirenéus: P+I+Re+N+Eu+S | P+I+Re+Ne+U+S
insulina: In+S+U+Li+Na | I+N+S+U+Li+Na
inativo: I+N+At+I+V+O | In+At+I+V+O | I+Na+Ti+V+O
ciclone: C+I+Cl+O+Ne
tabagismo: Ta+B+Ag+I+Sm+O | Ta+B+Ag+I+S+Mo
Op: O+P
Ohio: O+H+I+O
funcionalismo: F+U+N+C+I+O+N+Al+I+S+Mo | F+U+N+C+I+O+Na+Li+Sm+O | F+U+N+C+I+O+Na+Li+S+Mo | F+U+N+C+I+O+N+Al+I+Sm+O
presságio: Pr+Es+S+Ag+I+O | P+Re+S+S+Ag+I+O
po: P+O | Po
intencionar: I+N+Te+N+C+I+O+N+Ar | In+Te+N+C+I+O+N+Ar
amarra: Am+Ar+Ra
consternar: Co+N+S+Te+Rn+Ar | C+O+N+S+Te+Rn+Ar
confins: Co+N+F+I+N+S | Co+N+F+In+S | C+O+N+F+In+S | C+O+N+F+I+N+S
bávaro: Ba+V+Ar+O
setecentista: Se+Te+Ce+N+Ti+S+Ta
rapar: Ra+P+Ar
foca: F+O+Ca
Newark: Ne+W+Ar+K
focinho: F+O+C+I+N+H+O | F+O+C+I+N+Ho | F+O+C+In+Ho | F+O+C+I+Nh+O | F+O+C+In+H+O
berbere: B+Er+Be+Re
Baku: Ba+K+U
alfinete: Al+F+I+Ne+Te
frete: F+Re+Te
florescente: Fl+O+Re+S+Ce+N+Te
Bica: Bi+Ca | B+I+Ca
viga: V+I+Ga
vicentino: V+I+Ce+N+Ti+N+O | V+I+Ce+N+Ti+No
pupila: Pu+P+I+La | P+U+P+I+La
esburacar: Es+B+U+Ra+C+Ar
Couceiro: Co+U+Ce+Ir+O | C+O+U+Ce+Ir+O
Simon: S+I+Mo+N | Si+Mo+N
chamuscar: C+H+Am+U+Sc+Ar | C+H+Am+U+S+C+Ar
atinar: At+In+Ar | At+I+N+Ar
Arlindo: Ar+Li+Nd+O
gesso: Ge+S+S+O
clausura: Cl+Au+S+U+Ra | C+La+U+S+U+Ra
facho: F+Ac+H+O | F+Ac+Ho
Albano: Al+Ba+No | Al+Ba+N+O
up: U+P
Stasi: S+Ta+Si | S+Ta+S+I
nouo: N+O+U+O | No+U+O
Dylan: Dy+La+N
circulante: C+Ir+C+U+La+N+Te | C+Ir+Cu+La+N+Te
atalho: At+Al+H+O | At+Al+Ho
laivo: La+I+V+O
capitanear: Ca+P+I+Ta+Ne+Ar
Southampton: S+O+U+Th+Am+Pt+O+N
iconográfico: I+Co+N+Og+Ra+F+I+Co | I+C+O+N+Og+Ra+F+I+C+O | I+Co+N+Og+Ra+F+I+C+O | I+C+O+N+Og+Ra+F+I+Co
contabilista: C+O+N+Ta+B+I+Li+S+Ta | Co+N+Ta+B+I+Li+S+Ta | Co+N+Ta+Bi+Li+S+Ta | C+O+N+Ta+Bi+Li+S+Ta
circense: C+Ir+Ce+N+Se
cantinho: Ca+N+Ti+N+H+O | Ca+N+Ti+N+Ho | Ca+N+Ti+Nh+O
business: B+U+S+I+Ne+S+S | B+U+Si+N+Es+S | B+U+S+I+N+Es+S | B+U+Si+Ne+S+S | B+U+S+In+Es+S
Fonsecas: F+O+N+Se+C+As | F+O+N+Se+Ca+S
condescender: Co+Nd+Es+Ce+Nd+Er | C+O+Nd+Es+Ce+Nd+Er
cercear: C+Er+Ce+Ar
valar: V+Al+Ar
PowerPC: P+O+W+Er+P+C | Po+W+Er+P+C
gaita: Ga+I+Ta
tino: Ti+No | Ti+N+O
préstimo: Pr+Es+Ti+Mo | P+Re+S+Ti+Mo
cap: Ca+P
Ora: O+Ra
núpcias: N+U+P+C+I+As
campina: C+Am+P+I+Na
boina: B+O+I+Na
hepático: He+Pa+Ti+Co | He+P+At+I+Co | He+Pa+Ti+C+O | He+P+At+I+C+O
casebre: Ca+Se+B+Re
autista: Au+Ti+S+Ta
Seat: Se+At
ovar: O+V+Ar
oponente: O+Po+Ne+N+Te | O+P+O+Ne+N+Te
Frank: F+Ra+N+K
vip: V+I+P
tecnocrático: Te+C+N+O+C+Ra+Ti+Co | Te+C+No+C+Ra+Ti+C+O | Te+Cn+O+C+Ra+Ti+C+O | Te+C+N+O+C+Ra+Ti+C+O | Te+C+N+O+Cr+At+I+C+O | Te+C+No+Cr+At+I+C+O | Te+Cn+O+Cr+At+I+C+O | Te+Cn+O+C+Ra+Ti+Co | Te+C+No+C+Ra+Ti+Co | Te+C+N+O+Cr+At+I+Co
raspar: Ra+S+P+Ar
Lino: Li+N+O | Li+No
Constantinopla: C+O+N+S+Ta+N+Ti+No+P+La | C+O+N+S+Ta+N+Ti+N+O+P+La | Co+N+S+Ta+N+Ti+No+P+La | Co+N+S+Ta+N+Ti+N+O+P+La
cognitivo: C+Og+N+I+Ti+V+O | C+Og+Ni+Ti+V+O
cannabis: Ca+N+Na+Bi+S | Ca+N+Na+B+I+S
Acácio: Ac+Ac+I+O
lanche: La+N+C+He
Tahar: Ta+H+Ar
frondoso: Fr+O+Nd+Os+O | Fr+O+Nd+O+S+O
copioso: Co+P+I+Os+O | C+O+P+I+O+S+O | Co+P+I+O+S+O | C+O+P+I+Os+O
labiríntico: La+B+Ir+In+Ti+C+O | La+B+Ir+I+N+Ti+Co | La+B+Ir+In+Ti+Co | La+B+Ir+I+N+Ti+C+O
convergente: Co+N+V+Er+Ge+N+Te | C+O+N+V+Er+Ge+N+Te
conluio: Co+N+Lu+I+O | C+O+N+Lu+I+O
Colin: C+O+Li+N | Co+Li+N
calão: Ca+La+O
vinícola: V+I+N+I+C+O+La | V+In+I+Co+La | V+In+I+C+O+La | V+I+N+I+Co+La | V+I+Ni+Co+La | V+I+Ni+C+O+La
supersticioso: S+U+P+Er+S+Ti+C+I+Os+O | S+U+P+Er+S+Ti+C+I+O+S+O
monástico: Mo+N+As+Ti+Co | Mo+Na+S+Ti+Co | Mo+N+As+Ti+C+O | Mo+Na+S+Ti+C+O
frenesi: F+Re+Ne+S+I | F+Re+N+Es+I | F+Re+Ne+Si
ovino: O+V+In+O | O+V+I+N+O | O+V+I+No
neofascista: Ne+O+F+As+C+I+S+Ta
lacticínio: La+C+Ti+C+In+I+O | La+C+Ti+C+I+Ni+O | La+C+Ti+C+I+N+I+O
hamburger: H+Am+B+U+Rg+Er
onipotente: O+Ni+Po+Te+N+Te | O+Ni+P+O+Te+N+Te | O+N+I+P+O+Te+N+Te | O+N+I+Po+Te+N+Te
fóra: F+O+Ra
bobo: B+O+B+O
vastíssimo: V+As+Ti+S+Si+Mo | V+As+Ti+S+S+I+Mo
ponteiro: P+O+N+Te+Ir+O | Po+N+Te+Ir+O
Cantão: Ca+N+Ta+O
bicentenário: Bi+Ce+N+Te+N+Ar+I+O | B+I+Ce+N+Te+N+Ar+I+O
sege: Se+Ge
crear: C+Re+Ar
Baco: Ba+Co | Ba+C+O | B+Ac+O
pag: P+Ag
beta: Be+Ta
tear: Te+Ar
plafond: P+La+F+O+Nd
bondoso: B+O+Nd+O+S+O | B+O+Nd+Os+O
Rutskoi: Ru+Ts+K+O+I
crivo: Cr+I+V+O
banditismo: Ba+Nd+I+Ti+Sm+O | Ba+Nd+I+Ti+S+Mo
tai: Ta+I
espargir: Es+Pa+Rg+Ir
bucólico: B+U+C+O+Li+C+O | B+U+Co+Li+Co | B+U+Co+Li+C+O | B+U+C+O+Li+Co
Whitewater: W+H+I+Te+W+At+Er
lavra: La+V+Ra
cineclube: C+I+Ne+Cl+U+Be | C+I+Ne+C+Lu+Be
Ali: Al+I
laurear: La+U+Re+Ar
foraõ: F+O+Ra+O
campista: C+Am+P+I+S+Ta
cacau: Ca+C+Au | C+Ac+Au | Ca+Ca+U
Pasolini: P+As+O+Li+N+I | P+As+O+Li+Ni | Pa+S+O+Li+N+I | Pa+S+O+Li+Ni
atlas: At+La+S
Watergate: W+At+Er+Ga+Te
subchefe: S+U+B+C+He+Fe
esteio: Es+Te+I+O
espiga: Es+P+I+Ga
birra: B+Ir+Ra
vespertino: V+Es+P+Er+Ti+No | V+Es+P+Er+Ti+N+O
taipa: Ta+I+Pa
sufragar: S+U+Fr+Ag+Ar
psi: P+S+I | P+Si
gancho: Ga+N+C+Ho | Ga+N+C+H+O
batina: B+At+I+Na | Ba+Ti+Na
pretensioso: P+Re+Te+N+Si+O+S+O | P+Re+Te+N+S+I+O+S+O | P+Re+Te+N+S+I+Os+O | P+Re+Te+N+Si+Os+O
Pernambuco: P+Er+N+Am+B+U+Co | P+Er+N+Am+B+U+C+O
libertino: Li+B+Er+Ti+N+O | Li+B+Er+Ti+No
geógrafo: Ge+Og+Ra+F+O
fuso: F+U+S+O
campal: C+Am+P+Al
vociferar: V+O+C+I+F+Er+Ar
Sé: Se
propo: Pr+O+Po | Pr+O+P+O
Soponata: S+O+P+O+Na+Ta | S+O+Po+Na+Ta
resina: Re+Si+Na | Re+S+I+Na
infundir: I+N+F+U+Nd+Ir | In+F+U+Nd+Ir
Gates: Ga+Te+S
Cruges: Cr+U+Ge+S | C+Ru+Ge+S
son: S+O+N
serenata: Se+Re+Na+Ta
Papin: Pa+P+In | Pa+P+I+N
fraga: F+Ra+Ga
uivar: U+I+V+Ar
hooligan: Ho+O+Li+Ga+N | H+O+O+Li+Ga+N
flanela: F+La+Ne+La
crash: Cr+As+H | C+Ra+S+H
confessional: C+O+N+F+Es+Si+O+N+Al | C+O+N+F+Es+S+I+O+N+Al | C+O+N+Fe+S+S+I+O+N+Al | C+O+N+Fe+S+Si+O+N+Al | Co+N+F+Es+S+I+O+N+Al | Co+N+F+Es+Si+O+N+Al | Co+N+Fe+S+Si+O+N+Al
charneca: C+H+Ar+Ne+Ca
Castanheira: C+As+Ta+N+He+I+Ra | Ca+S+Ta+N+He+I+Ra
botânico: B+O+Ta+N+I+Co | B+O+Ta+Ni+Co | B+O+Ta+N+I+C+O | B+O+Ta+Ni+C+O
Sega: Se+Ga
rábula: Ra+B+U+La
náutica: Na+U+Ti+Ca | N+Au+Ti+Ca
monopolista: Mo+N+O+Po+Li+S+Ta | Mo+N+O+P+O+Li+S+Ta | Mo+No+Po+Li+S+Ta | Mo+No+P+O+Li+S+Ta
calafrio: Ca+La+Fr+I+O
carente: Ca+Re+N+Te
argentina: Ar+Ge+N+Ti+Na
acondicionar: Ac+O+Nd+I+C+I+O+N+Ar
Fini: F+I+N+I | F+In+I | F+I+Ni
cabala: Ca+Ba+La
Unicre: U+N+I+C+Re | U+Ni+C+Re
sensacionalismo: Se+N+S+Ac+I+O+Na+Li+Sm+O | Se+N+S+Ac+I+O+Na+Li+S+Mo | Se+N+S+Ac+I+O+N+Al+I+S+Mo | Se+N+S+Ac+I+O+N+Al+I+Sm+O
bósnio: B+Os+N+I+O | B+O+S+N+I+O | B+O+Sn+I+O | B+O+S+Ni+O | B+Os+Ni+O
Artiach: Ar+Ti+Ac+H
sena: Se+Na
imobilismo: I+Mo+B+I+Li+Sm+O | I+Mo+Bi+Li+Sm+O | I+Mo+Bi+Li+S+Mo | I+Mo+B+I+Li+S+Mo
hiato: H+I+At+O
General: Ge+N+Er+Al
parafuso: Pa+Ra+F+U+S+O
âmago: Am+Ag+O
farpar: F+Ar+P+Ar
escancarar: Es+Ca+N+C+Ar+Ar
Bayer: Ba+Y+Er
serial: S+Er+I+Al
PoSat: P+O+S+At | P+Os+At | Po+S+At
opressivo: O+P+Re+S+S+I+V+O | O+Pr+Es+Si+V+O | O+Pr+Es+S+I+V+O | O+P+Re+S+Si+V+O
lascivo: La+Sc+I+V+O | La+S+C+I+V+O
inconstante: I+N+Co+N+S+Ta+N+Te | In+Co+N+S+Ta+N+Te | In+C+O+N+S+Ta+N+Te | I+N+C+O+N+S+Ta+N+Te
incinerar: In+C+In+Er+Ar | I+N+C+In+Er+Ar | In+C+I+N+Er+Ar | I+N+C+I+N+Er+Ar
fenício: Fe+Ni+C+I+O | Fe+N+I+C+I+O
te: Te
Festina: F+Es+Ti+Na | Fe+S+Ti+Na
recato: Re+C+At+O
Mourão: Mo+U+Ra+O
felino: Fe+Li+No | Fe+Li+N+O
caserna: Ca+S+Er+Na | C+As+Er+Na
Calvário: C+Al+V+Ar+I+O | Ca+Lv+Ar+I+O
Brás: Br+As | B+Ra+S
autismo: Au+Ti+S+Mo | Au+Ti+Sm+O
mora: Mo+Ra
Tico: Ti+C+O | Ti+Co
siso: Si+S+O | S+I+S+O
novato: N+O+V+At+O | No+V+At+O
geracional: Ge+Ra+C+I+O+N+Al
caucionar: Ca+U+C+I+O+N+Ar | C+Au+C+I+O+N+Ar
catarata: Ca+Ta+Ra+Ta
atípico: At+I+P+I+C+O | At+I+P+I+Co
propagandístico: Pr+O+Pa+Ga+Nd+I+S+Ti+Co | Pr+O+Pa+Ga+Nd+I+S+Ti+C+O
ovário: O+V+Ar+I+O
onerar: O+N+Er+Ar
gasolineira: Ga+S+O+Li+Ne+I+Ra
auio: Au+I+O
mono: Mo+No | Mo+N+O
flash: F+La+S+H | Fl+As+H
crasso: C+Ra+S+S+O | Cr+As+S+O
canário: Ca+N+Ar+I+O
retina: Re+Ti+Na
Claro: Cl+Ar+O
sufocante: S+U+F+O+Ca+N+Te
spray: S+P+Ra+Y
Escobar: Es+Co+B+Ar | Es+C+O+B+Ar
cintilante: C+I+N+Ti+La+N+Te | C+In+Ti+La+N+Te
bisar: Bi+S+Ar | B+I+S+Ar
amplificar: Am+P+Li+F+I+C+Ar
centeio: Ce+N+Te+I+O
vertebral: V+Er+Te+Br+Al
tangencial: Ta+N+Ge+N+C+I+Al
profícuo: Pr+O+F+I+C+U+O | Pr+O+F+I+Cu+O
Ota: O+Ta
tipificar: Ti+P+I+F+I+C+Ar
Tintin: Ti+N+Ti+N
skin: S+K+I+N | S+K+In
revivalismo: Re+V+I+V+Al+I+Sm+O | Re+V+I+V+Al+I+S+Mo
Pacers: P+Ac+Er+S | Pa+C+Er+S
Nando: Na+Nd+O
iniciático: I+N+I+C+I+At+I+C+O | I+Ni+C+I+At+I+Co | In+I+C+I+At+I+C+O | I+Ni+C+I+At+I+C+O | I+N+I+C+I+At+I+Co | In+I+C+I+At+I+Co
Fialho: F+I+Al+Ho | F+I+Al+H+O
facial: F+Ac+I+Al
cipreste: C+I+Pr+Es+Te | C+I+P+Re+S+Te
carabina: Ca+Ra+B+I+Na | Ca+Ra+Bi+Na
arfar: Ar+F+Ar
Vukovar: V+U+K+O+V+Ar
unico: U+Ni+C+O | U+N+I+C+O | U+N+I+Co | U+Ni+Co
Cáceres: Ca+Ce+Re+S | Ca+C+Er+Es | C+Ac+Er+Es
bogey: B+O+Ge+Y
altista: Al+Ti+S+Ta
paternalista: P+At+Er+N+Al+I+S+Ta | P+At+Er+Na+Li+S+Ta | Pa+Te+Rn+Al+I+S+Ta
Solino: S+O+Li+No | S+O+Li+N+O
chupar: C+H+U+P+Ar
psicose: P+S+I+Co+Se | P+S+I+C+O+Se | P+Si+Co+Se | P+Si+C+O+Se
hera: He+Ra
Simone: S+I+Mo+Ne | Si+Mo+Ne
Per: P+Er
palheiro: P+Al+He+Ir+O
ferrenho: F+Er+Re+Nh+O | F+Er+Re+N+H+O | F+Er+Re+N+Ho
assomo: As+S+O+Mo
virginal: V+I+Rg+I+N+Al | V+I+Rg+In+Al
salmo: S+Al+Mo
refrega: Re+F+Re+Ga
galã: Ga+La
balístico: Ba+Li+S+Ti+C+O | B+Al+I+S+Ti+Co | Ba+Li+S+Ti+Co | B+Al+I+S+Ti+C+O
auréola: Au+Re+O+La
víveres: V+I+V+Er+Es
cio: C+I+O
ac: Ac
pinta: P+I+N+Ta | P+In+Ta
palpite: P+Al+P+I+Te
caríssimo: C+Ar+I+S+S+I+Mo | C+Ar+I+S+Si+Mo
Uíge: U+I+Ge
Stich: S+Ti+C+H
Solana: S+O+La+Na
parceira: P+Ar+Ce+I+Ra
Hergé: H+Er+Ge
fundiário: F+U+Nd+I+Ar+I+O
crespo: Cr+Es+P+O | C+Re+S+Po | C+Re+S+P+O | Cr+Es+Po
piscícola: P+I+Sc+I+C+O+La | P+I+S+C+I+Co+La | P+I+Sc+I+Co+La | P+I+S+C+I+C+O+La
binário: Bi+N+Ar+I+O | B+In+Ar+I+O | B+I+N+Ar+I+O
Bali: Ba+Li | B+Al+I
Continente: Co+N+Ti+Ne+N+Te | C+O+N+Ti+Ne+N+Te
bestial: B+Es+Ti+Al | Be+S+Ti+Al
teclista: Te+Cl+I+S+Ta | Te+C+Li+S+Ta
Sacchi: S+Ac+C+H+I
raciocinar: Ra+C+I+O+C+I+N+Ar | Ra+C+I+O+C+In+Ar
peru: P+Er+U
Paulão: Pa+U+La+O | P+Au+La+O
esclerose: Es+Cl+Er+O+Se
superlativo: S+U+P+Er+La+Ti+V+O
Renoir: Re+No+Ir | Re+N+O+Ir
Orfeu: O+Rf+Eu
neblina: Ne+B+Li+Na
Nancy: Na+N+C+Y
McCarthy: Mc+C+Ar+Th+Y
ornato: O+Rn+At+O
Sonics: S+O+N+I+Cs | S+O+Ni+C+S | S+O+Ni+Cs | S+O+N+I+C+S
partio: P+Ar+Ti+O
Nepal: Ne+P+Al
mó: Mo
culinário: C+U+Li+N+Ar+I+O | Cu+Li+N+Ar+I+O
Cícero: C+I+C+Er+O
batota: B+At+O+Ta
Viagra: V+I+Ag+Ra
Árvore: Ar+V+O+Re
espasmo: Es+Pa+Sm+O | Es+P+As+Mo | Es+Pa+S+Mo
catão: Ca+Ta+O
óbice: O+B+I+Ce | O+Bi+Ce
barata: Ba+Ra+Ta
Tires: Ti+Re+S
precaver: P+Re+Ca+V+Er
Esteves: Es+Te+V+Es
estalinismo: Es+Ta+Li+Ni+S+Mo | Es+Ta+Li+Ni+Sm+O | Es+Ta+Li+N+I+Sm+O | Es+Ta+Li+N+I+S+Mo
superintender: S+U+P+Er+I+N+Te+Nd+Er | S+U+P+Er+In+Te+Nd+Er
rês: Re+S
montão: Mo+N+Ta+O
latão: La+Ta+O
kosovar: K+Os+O+V+Ar | K+O+S+O+V+Ar
internacionalista: In+Te+Rn+Ac+I+O+N+Al+I+S+Ta | I+N+Te+Rn+Ac+I+O+N+Al+I+S+Ta | I+N+Te+Rn+Ac+I+O+Na+Li+S+Ta | In+Te+Rn+Ac+I+O+Na+Li+S+Ta
fogoso: F+Og+Os+O | F+Og+O+S+O
coco: Co+C+O | C+O+Co | C+O+C+O | Co+Co
choupo: C+Ho+U+Po | C+H+O+U+Po | C+Ho+U+P+O | C+H+O+U+P+O
universalista: U+Ni+V+Er+S+Al+I+S+Ta | U+N+I+V+Er+S+Al+I+S+Ta
iceberg: I+Ce+Be+Rg
falsar: F+Al+S+Ar
bebop: Be+B+O+P
cenográfico: Ce+N+Og+Ra+F+I+C+O | Ce+N+Og+Ra+F+I+Co
caco: Ca+Co | C+Ac+O | Ca+C+O
voluptuoso: V+O+Lu+Pt+U+Os+O | V+O+Lu+Pt+U+O+S+O
Refer: Re+F+Er
polaca: P+O+La+Ca | Po+La+Ca
hauer: H+Au+Er
sarin: S+Ar+In | S+Ar+I+N
arranhar: Ar+Ra+N+H+Ar | Ar+Ra+Nh+Ar
play: P+La+Y
Ita: I+Ta
curativo: Cu+Ra+Ti+V+O | C+U+Ra+Ti+V+O
víscera: V+I+S+Ce+Ra
Patrese: P+At+Re+Se
fofo: F+O+F+O
cataclismo: Ca+Ta+C+Li+S+Mo | C+At+Ac+Li+Sm+O | C+At+Ac+Li+S+Mo | Ca+Ta+Cl+I+S+Mo | Ca+Ta+C+Li+Sm+O
saciar: S+Ac+I+Ar
Indochina: I+Nd+O+C+H+I+Na
sir: S+Ir
sintaxe: Si+N+Ta+Xe | S+I+N+Ta+Xe | S+In+Ta+Xe
Píndaro: P+I+Nd+Ar+O
plu: P+Lu
forão: F+O+Ra+O
ferreiro: F+Er+Re+Ir+O
baralho: B+Ar+Al+H+O | B+Ar+Al+Ho
sarampo: S+Ar+Am+Po | S+Ar+Am+P+O
rebuscar: Re+B+U+S+C+Ar | Re+B+U+Sc+Ar
pastiche: P+As+Ti+C+He | Pa+S+Ti+C+He
os: Os | O+S
celibato: Ce+Li+B+At+O
Cabanelas: Ca+Ba+Ne+La+S
pateta: Pa+Te+Ta
Navarra: Na+V+Ar+Ra
invisual: I+N+V+I+S+U+Al | In+V+I+S+U+Al
autenticar: Au+Te+N+Ti+C+Ar
sífilis: Si+F+I+Li+S | S+I+F+I+Li+S
pré: P+Re
ovni: O+V+Ni | O+V+N+I
naturalismo: N+At+U+Ra+Li+Sm+O | N+At+U+Ra+Li+S+Mo
Irene: I+Re+Ne
inato: In+At+O | I+N+At+O
Francis: F+Ra+N+C+I+S
Arsénio: Ar+Se+N+I+O | Ar+Se+Ni+O
Utah: U+Ta+H
Karpov: K+Ar+P+O+V | K+Ar+Po+V
Gala: Ga+La
circunstante: C+Ir+Cu+N+S+Ta+N+Te | C+Ir+C+U+N+S+Ta+N+Te
cata: Ca+Ta
vingativo: V+In+Ga+Ti+V+O | V+I+N+Ga+Ti+V+O
verberar: V+Er+B+Er+Ar
friso: Fr+I+S+O
bálsamo: B+Al+S+Am+O
Batista: B+At+I+S+Ta | Ba+Ti+S+Ta
Vichy: V+I+C+H+Y
sy: S+Y
subornar: S+U+B+O+Rn+Ar
sarcófago: S+Ar+C+O+F+Ag+O | S+Ar+Co+F+Ag+O
árctico: Ar+C+Ti+Co | Ar+C+Ti+C+O
néscio: N+Es+C+I+O | Ne+Sc+I+O | Ne+S+C+I+O
lastimoso: La+S+Ti+Mo+S+O
Inocêncio: In+O+Ce+N+C+I+O | I+N+O+Ce+N+C+I+O | I+No+Ce+N+C+I+O
coar: C+O+Ar | Co+Ar
CiU: C+I+U
canseira: Ca+N+Se+I+Ra
calunioso: C+Al+U+N+I+Os+O | C+Al+U+Ni+O+S+O | Ca+Lu+N+I+Os+O | Ca+Lu+Ni+Os+O | Ca+Lu+N+I+O+S+O | Ca+Lu+Ni+O+S+O | C+Al+U+N+I+O+S+O
alpino: Al+P+In+O | Al+P+I+N+O | Al+P+I+No
Titi: Ti+Ti
Tarantino: Ta+Ra+N+Ti+N+O | Ta+Ra+N+Ti+No
gasoso: Ga+S+Os+O | Ga+S+O+S+O
estanho: Es+Ta+N+H+O | Es+Ta+N+Ho | Es+Ta+Nh+O
ceifar: Ce+I+F+Ar
catarse: C+At+Ar+Se
bi: Bi | B+I
vogar: V+Og+Ar
sucessora: S+U+Ce+S+S+O+Ra | S+U+C+Es+S+O+Ra
conciso: C+O+N+C+I+S+O | Co+N+C+I+S+O
centavo: Ce+N+Ta+V+O
carcereiro: C+Ar+Ce+Re+Ir+O
caramba: C+Ar+Am+Ba
Sorbonne: S+O+Rb+O+N+Ne
sela: Se+La
Perú: P+Er+U
nenh: Ne+Nh | Ne+N+H
espraiar: Es+P+Ra+I+Ar
careta: Ca+Re+Ta
barranco: B+Ar+Ra+N+C+O | B+Ar+Ra+N+Co
ocupacional: O+Cu+P+Ac+I+O+N+Al | O+Cu+Pa+C+I+O+N+Al | O+C+U+Pa+C+I+O+N+Al | O+C+U+P+Ac+I+O+N+Al
cheiroso: C+He+Ir+O+S+O | C+He+Ir+Os+O
Bucelas: B+U+Ce+La+S
psicopata: P+S+I+C+O+Pa+Ta | P+Si+Co+Pa+Ta | P+S+I+Co+Pa+Ta | P+Si+C+O+Pa+Ta
Mora: Mo+Ra
mocho: Mo+C+Ho | Mo+C+H+O
lupa: Lu+Pa
aglutinar: Ag+Lu+Ti+N+Ar
policiário: P+O+Li+C+I+Ar+I+O | Po+Li+C+I+Ar+I+O
garfo: Ga+Rf+O
Lipcsei: Li+P+C+Se+I
Honduras: Ho+Nd+U+Ra+S | H+O+Nd+U+Ra+S
gebo: Ge+B+O
rarear: Ra+Re+Ar
platina: P+La+Ti+Na
Lacticoop: La+C+Ti+Co+O+P | La+C+Ti+C+O+O+P
isco: I+Sc+O | I+S+C+O | I+S+Co
fresta: Fr+Es+Ta | F+Re+S+Ta
cheirinho: C+He+Ir+I+N+H+O | C+He+Ir+In+H+O | C+He+Ir+In+Ho | C+He+Ir+I+Nh+O | C+He+Ir+I+N+Ho
bretão: B+Re+Ta+O
bege: Be+Ge
usura: U+S+U+Ra
rá: Ra
pacense: Pa+Ce+N+Se
Bétis: Be+Ti+S
bafo: Ba+F+O
Nam: N+Am
naco: Na+C+O | N+Ac+O | Na+Co
Lage: La+Ge
Hernâni: H+Er+Na+Ni | H+Er+Na+N+I
Gandhi: Ga+Nd+H+I
fastio: F+As+Ti+O
crivar: Cr+I+V+Ar
Moreirense: Mo+Re+I+Re+N+Se
esporão: Es+P+O+Ra+O | Es+Po+Ra+O
cone: Co+Ne | C+O+Ne
agasalho: Ag+As+Al+Ho | Ag+As+Al+H+O
Tancos: Ta+N+C+O+S | Ta+N+Co+S | Ta+N+C+Os
repassar: Re+P+As+S+Ar | Re+Pa+S+S+Ar
Pai: Pa+I
Nandinho: Na+Nd+I+Nh+O | Na+Nd+I+N+H+O | Na+Nd+I+N+Ho | Na+Nd+In+Ho | Na+Nd+In+H+O
Monk: Mo+N+K
Honecker: Ho+Ne+C+K+Er | H+O+Ne+C+K+Er
acutilante: Ac+U+Ti+La+N+Te
recepcionista: Re+Ce+P+C+I+O+Ni+S+Ta | Re+Ce+P+C+I+O+N+I+S+Ta
oferente: O+Fe+Re+N+Te
insuflar: I+N+S+U+Fl+Ar | In+S+U+Fl+Ar
freático: F+Re+At+I+C+O | F+Re+At+I+Co
responsar: Re+S+Po+N+S+Ar | Re+S+P+O+N+S+Ar
opcional: O+P+C+I+O+N+Al
obscurantismo: O+B+Sc+U+Ra+N+Ti+S+Mo | O+B+S+C+U+Ra+N+Ti+Sm+O | O+B+S+C+U+Ra+N+Ti+S+Mo | O+B+Sc+U+Ra+N+Ti+Sm+O | O+B+S+Cu+Ra+N+Ti+Sm+O | O+B+S+Cu+Ra+N+Ti+S+Mo
gays: Ga+Y+S
crosta: Cr+O+S+Ta | Cr+Os+Ta
hipnótico: H+I+P+N+O+Ti+C+O | H+I+P+No+Ti+Co | H+I+P+No+Ti+C+O | H+I+P+N+O+Ti+Co
escaparate: Es+Ca+Pa+Ra+Te
canino: Ca+N+I+No | Ca+N+In+O | Ca+Ni+N+O | Ca+Ni+No | Ca+N+I+N+O
Bono: B+O+No | B+O+N+O
Bibi: Bi+B+I | Bi+Bi | B+I+Bi | B+I+B+I
atte: At+Te
regenerar: Re+Ge+N+Er+Ar
pascal: Pa+Sc+Al | P+As+C+Al | Pa+S+C+Al
palpitante: P+Al+P+I+Ta+N+Te
nupcial: N+U+P+C+I+Al
genealógico: Ge+Ne+Al+Og+I+Co | Ge+Ne+Al+Og+I+C+O
fraternal: Fr+At+Er+N+Al | F+Ra+Te+Rn+Al
Coutinho: Co+U+Ti+N+H+O | Co+U+Ti+N+Ho | C+O+U+Ti+Nh+O | C+O+U+Ti+N+Ho | C+O+U+Ti+N+H+O | Co+U+Ti+Nh+O
Neptuno: Ne+Pt+U+No | Ne+Pt+U+N+O
lince: Li+N+Ce
Verona: V+Er+O+Na
sin: Si+N | S+I+N | S+In
Ray: Ra+Y
prendar: P+Re+Nd+Ar
patinar: Pa+Ti+N+Ar | P+At+In+Ar | P+At+I+N+Ar
paisagista: Pa+I+S+Ag+I+S+Ta
finta: F+I+N+Ta | F+In+Ta
Fassbinder: F+As+Sb+I+Nd+Er | F+As+S+B+I+Nd+Er | F+As+S+Bi+Nd+Er
sinónimo: Si+No+Ni+Mo | S+In+O+N+I+Mo | S+I+N+O+N+I+Mo | S+In+O+Ni+Mo | S+I+N+O+Ni+Mo | Si+No+N+I+Mo | S+I+No+N+I+Mo | Si+N+O+N+I+Mo | Si+N+O+Ni+Mo
rubi: Ru+B+I | Ru+Bi
orgasmo: O+Rg+As+Mo
lage: La+Ge
cliché: C+Li+C+He | Cl+I+C+He
America: Am+Er+I+Ca
viseu: V+I+Se+U | V+I+S+Eu
uas: U+As
narcótico: N+Ar+Co+Ti+Co | N+Ar+C+O+Ti+Co | N+Ar+C+O+Ti+C+O | N+Ar+Co+Ti+C+O
inalar: I+N+Al+Ar | In+Al+Ar
cambalhota: C+Am+B+Al+Ho+Ta | C+Am+B+Al+H+O+Ta
vitivinícola: V+I+Ti+V+I+Ni+C+O+La | V+I+Ti+V+I+N+I+Co+La | V+I+Ti+V+In+I+Co+La | V+I+Ti+V+I+Ni+Co+La | V+I+Ti+V+I+N+I+C+O+La | V+I+Ti+V+In+I+C+O+La
tangente: Ta+N+Ge+N+Te
offer: O+F+F+Er
Nicolau: Ni+C+O+La+U | N+I+C+O+La+U | N+I+Co+La+U | Ni+Co+La+U
Carvalheiras: C+Ar+V+Al+He+Ir+As | C+Ar+V+Al+He+I+Ra+S
carnal: Ca+Rn+Al | C+Ar+N+Al
alar: Al+Ar
paralítico: Pa+Ra+Li+Ti+C+O | Pa+Ra+Li+Ti+Co | P+Ar+Al+I+Ti+Co | P+Ar+Al+I+Ti+C+O
papão: Pa+Pa+O
Ímola: I+Mo+La
Veríssimo: V+Er+I+S+Si+Mo | V+Er+I+S+S+I+Mo
Pires: P+Ir+Es | P+I+Re+S
ioga: I+O+Ga
cavo: Ca+V+O
vero: V+Er+O
Silvério: S+I+Lv+Er+I+O | Si+Lv+Er+I+O
senar: Se+N+Ar
ravina: Ra+V+I+Na
notebook: N+O+Te+B+O+O+K | No+Te+B+O+O+K
Fary: F+Ar+Y
bússola: B+U+S+S+O+La
Auckland: Au+C+K+La+Nd
verga: V+Er+Ga
team: Te+Am
coio: Co+I+O | C+O+I+O
caneca: Ca+Ne+Ca
Barclays: B+Ar+C+La+Y+S
bagatela: Ba+Ga+Te+La
tinteiro: Ti+N+Te+Ir+O
reunificar: Re+U+N+I+F+I+C+Ar | Re+U+Ni+F+I+C+Ar
repar: Re+P+Ar
plátano: P+La+Ta+N+O | P+La+Ta+No
Pierre: P+I+Er+Re
Panic: Pa+Ni+C | Pa+N+I+C
Heat: He+At
carreiro: C+Ar+Re+Ir+O
agachar: Ag+Ac+H+Ar
varar: V+Ar+Ar
liteira: Li+Te+I+Ra
linfático: Li+N+F+At+I+Co | Li+N+F+At+I+C+O
carpir: C+Ar+P+Ir
amir: Am+Ir
Puccini: Pu+C+C+I+N+I | P+U+C+C+I+Ni | P+U+C+C+In+I | Pu+C+C+I+Ni | P+U+C+C+I+N+I | Pu+C+C+In+I
Cook: C+O+O+K | Co+O+K
bichinho: B+I+C+H+In+H+O | B+I+C+H+I+N+H+O | B+I+C+H+In+Ho | B+I+C+H+I+Nh+O | Bi+C+H+I+N+Ho | Bi+C+H+I+N+H+O | Bi+C+H+I+Nh+O | B+I+C+H+I+N+Ho | Bi+C+H+In+H+O | Bi+C+H+In+Ho
pâncreas: Pa+N+C+Re+As
Neca: Ne+Ca
link: Li+N+K
liceal: Li+Ce+Al
escriba: Es+Cr+I+Ba
Crato: Cr+At+O
sebe: Se+Be
recessivo: Re+Ce+S+Si+V+O | Re+Ce+S+S+I+V+O | Re+C+Es+Si+V+O | Re+C+Es+S+I+V+O
Bispo: B+I+S+P+O | B+I+S+Po | Bi+S+P+O | Bi+S+Po
bibliotecário: B+I+B+Li+O+Te+C+Ar+I+O | Bi+B+Li+O+Te+C+Ar+I+O
agrura: Ag+Ru+Ra
Rainey: Ra+I+Ne+Y
pratear: P+Ra+Te+Ar
fecundar: Fe+C+U+Nd+Ar | Fe+Cu+Nd+Ar
cubar: C+U+B+Ar | Cu+B+Ar
Claes: C+La+Es
bramir: Br+Am+Ir
amoreira: Am+O+Re+I+Ra
pontifício: P+O+N+Ti+F+I+C+I+O | Po+N+Ti+F+I+C+I+O
finura: F+In+U+Ra | F+I+N+U+Ra
Chichisbéu: C+H+I+C+H+I+S+B+Eu | C+H+I+C+H+I+S+Be+U | C+H+I+C+H+I+Sb+Eu
Campo: C+Am+P+O | C+Am+Po
barbear: B+Ar+Be+Ar
back: B+Ac+K | Ba+C+K
Você: V+O+Ce
Soyo: S+O+Y+O
recobrar: Re+C+O+Br+Ar | Re+Co+Br+Ar
reagrupar: Re+Ag+Ru+P+Ar
incandescente: I+N+Ca+Nd+Es+Ce+N+Te | In+Ca+Nd+Es+Ce+N+Te
Corfu: Co+Rf+U | C+O+Rf+U
car: C+Ar
Bundesliga: B+U+Nd+Es+Li+Ga
subentender: S+U+Be+N+Te+Nd+Er
obscurecer: O+B+S+C+U+Re+C+Er | O+B+S+Cu+Re+C+Er | O+B+Sc+U+Re+C+Er
Klaus: K+La+U+S
charneira: C+H+Ar+Ne+I+Ra
bravio: B+Ra+V+I+O
Thern: Th+Er+N
Induráin: I+Nd+U+Ra+I+N | I+Nd+U+Ra+In
achega: Ac+He+Ga
Sou: S+O+U
néon: Ne+O+N
fatalismo: F+At+Al+I+Sm+O | F+At+Al+I+S+Mo
casario: Ca+S+Ar+I+O | C+As+Ar+I+O
calcinar: C+Al+C+I+N+Ar | C+Al+C+In+Ar
Alípio: Al+I+P+I+O
alcunhar: Al+Cu+N+H+Ar | Al+C+U+N+H+Ar | Al+Cu+Nh+Ar | Al+C+U+Nh+Ar
tico: Ti+C+O | Ti+Co
pinga: P+In+Ga | P+I+N+Ga
nacer: N+Ac+Er | Na+C+Er
fresca: F+Re+S+Ca | Fr+Es+Ca
víbora: V+I+B+O+Ra
suco: S+U+Co | S+U+C+O
Sra: S+Ra
scanner: S+Ca+N+N+Er
Parkinson: P+Ar+K+In+S+O+N | P+Ar+K+I+N+S+O+N
mouco: Mo+U+C+O | Mo+U+Co
fonográfico: F+O+N+Og+Ra+F+I+Co | F+O+N+Og+Ra+F+I+C+O
chinela: C+H+I+Ne+La
Bruges: B+Ru+Ge+S | Br+U+Ge+S
vacilante: V+Ac+I+La+N+Te
Técnico: Te+C+N+I+Co | Te+Cn+I+C+O | Te+Cn+I+Co | Te+C+N+I+C+O | Te+C+Ni+C+O
sobrante: S+O+B+Ra+N+Te
rascunho: Ra+Sc+U+N+H+O | Ra+S+C+U+Nh+O | Ra+S+C+U+N+Ho | Ra+S+C+U+N+H+O | Ra+Sc+U+Nh+O | Ra+Sc+U+N+Ho | Ra+S+Cu+N+H+O | Ra+S+Cu+Nh+O | Ra+S+Cu+N+Ho
pino: P+I+N+O | P+In+O | P+I+No
fruir: F+Ru+Ir | Fr+U+Ir
flashe: Fl+As+He | F+La+S+He
barreiro: B+Ar+Re+Ir+O
alfarrabista: Al+F+Ar+Ra+B+I+S+Ta | Al+F+Ar+Ra+Bi+S+Ta
acerbo: Ac+Er+B+O
terapeuta: Te+Ra+P+Eu+Ta
Rai: Ra+I
Bosch: B+Os+C+H | B+O+S+C+H | B+O+Sc+H
Bergkamp: Be+Rg+K+Am+P
www: W+W+W
Távora: Ta+V+O+Ra
suplicante: S+U+P+Li+Ca+N+Te
lula: Lu+La
infindo: I+N+F+I+Nd+O | In+F+I+Nd+O
chita: C+H+I+Ta
Camac: C+Am+Ac
Baltimore: B+Al+Ti+Mo+Re
Bahrein: Ba+H+Re+I+N | Ba+H+Re+In
acre: Ac+Re
Scalfaro: Sc+Al+F+Ar+O | S+C+Al+F+Ar+O
Sacatrapo: S+Ac+At+Ra+Po | S+Ac+At+Ra+P+O
pipoca: P+I+Po+Ca | P+I+P+O+Ca
Pav: Pa+V
lanifício: La+N+I+F+I+C+I+O | La+Ni+F+I+C+I+O
espora: Es+Po+Ra | Es+P+O+Ra
cantata: Ca+N+Ta+Ta
Barra: B+Ar+Ra
Kobe: K+O+Be
gana: Ga+Na
estacionário: Es+Ta+C+I+O+N+Ar+I+O
crack: Cr+Ac+K | C+Ra+C+K
Cirene: C+I+Re+Ne
Cali: C+Al+I | Ca+Li
Calcutá: C+Al+C+U+Ta | C+Al+Cu+Ta
th: Th
indigente: I+Nd+I+Ge+N+Te
heptatlo: He+P+Ta+Tl+O
Águas: Ag+U+As
falacioso: F+Al+Ac+I+O+S+O | F+Al+Ac+I+Os+O
cutâneo: C+U+Ta+Ne+O | Cu+Ta+Ne+O
Cesariny: C+Es+Ar+I+N+Y | C+Es+Ar+In+Y | Ce+S+Ar+I+N+Y | Ce+S+Ar+In+Y
Ceilão: Ce+I+La+O
Cavaliers: Ca+V+Al+I+Er+S
Altis: Al+Ti+S
teso: Te+S+O
Proteu: Pr+O+Te+U
proibitivo: Pr+O+I+Bi+Ti+V+O | Pr+O+I+B+I+Ti+V+O
Fontes: F+O+N+Te+S
feno: Fe+No | Fe+N+O
cicerone: C+I+C+Er+O+Ne
cepa: Ce+Pa
Alcácer: Al+Ca+C+Er | Al+C+Ac+Er
visceral: V+I+Sc+Er+Al | V+I+S+C+Er+Al
sse: S+Se
protão: Pr+O+Ta+O
pouo: Po+U+O | P+O+U+O
inconsistente: In+C+O+N+Si+S+Te+N+Te | I+N+C+O+N+S+I+S+Te+N+Te | I+N+Co+N+S+I+S+Te+N+Te | I+N+C+O+N+Si+S+Te+N+Te | In+C+O+N+S+I+S+Te+N+Te | In+Co+N+S+I+S+Te+N+Te | I+N+Co+N+Si+S+Te+N+Te | In+Co+N+Si+S+Te+N+Te
carniceiro: C+Ar+Ni+Ce+Ir+O | C+Ar+N+I+Ce+Ir+O | Ca+Rn+I+Ce+Ir+O
calculista: C+Al+Cu+Li+S+Ta | C+Al+C+U+Li+S+Ta
opróbrio: O+Pr+O+Br+I+O
Laos: La+O+S | La+Os
Ionesco: I+O+Ne+Sc+O | I+O+N+Es+Co | I+O+Ne+S+C+O | I+O+Ne+S+Co | I+O+N+Es+C+O
calo: C+Al+O
Alasca: Al+As+Ca
Tchekov: Tc+He+K+O+V
Salvaterra: S+Al+V+At+Er+Ra
plateau: P+La+Te+Au
patife: Pa+Ti+Fe | P+At+I+Fe
Natário: N+At+Ar+I+O
ganês: Ga+N+Es | Ga+Ne+S
Clark: Cl+Ar+K
Cherbakov: C+H+Er+Ba+K+O+V
asseio: As+Se+I+O
papo: Pa+P+O | Pa+Po
incarnar: In+C+Ar+N+Ar | In+Ca+Rn+Ar | I+N+C+Ar+N+Ar | I+N+Ca+Rn+Ar
Bárbara: B+Ar+Ba+Ra
alpinista: Al+P+I+N+I+S+Ta | Al+P+I+Ni+S+Ta | Al+P+In+I+S+Ta
ficcionar: F+I+C+C+I+O+N+Ar
violão: V+I+O+La+O
ui: U+I
ressarcir: Re+S+S+Ar+C+Ir
pirotécnico: P+Ir+O+Te+C+N+I+C+O | P+Ir+O+Te+Cn+I+Co | P+Ir+O+Te+C+N+I+Co | P+Ir+O+Te+Cn+I+C+O | P+Ir+O+Te+C+Ni+C+O
pause: Pa+U+Se | P+Au+Se
frutificar: Fr+U+Ti+F+I+C+Ar | F+Ru+Ti+F+I+C+Ar
Coina: Co+I+Na | C+O+I+Na
retaliar: Re+Ta+Li+Ar
reservista: Re+S+Er+V+I+S+Ta
Playboy: P+La+Y+B+O+Y | P+La+Yb+O+Y
indiciário: I+Nd+I+C+I+Ar+I+O
cafeína: Ca+Fe+I+Na
Aguiar: Ag+U+I+Ar
viés: V+I+Es
Sharon: S+H+Ar+O+N
know: K+N+O+W | K+No+W
iconoclasta: I+C+O+No+C+La+S+Ta | I+C+O+N+O+C+La+S+Ta | I+Co+No+C+La+S+Ta | I+Co+No+Cl+As+Ta | I+Co+N+O+Cl+As+Ta | I+Co+N+O+C+La+S+Ta | I+C+O+N+O+Cl+As+Ta
cabaré: Ca+Ba+Re
bonina: B+O+Ni+Na | B+O+N+I+Na
beatificar: Be+At+I+F+I+C+Ar
Barcelinhos: B+Ar+Ce+Li+Nh+O+S | B+Ar+Ce+Li+N+Ho+S | B+Ar+Ce+Li+Nh+Os | B+Ar+Ce+Li+N+H+O+S | B+Ar+Ce+Li+N+H+Os
Sob: S+O+B
raivoso: Ra+I+V+O+S+O | Ra+I+V+Os+O
pêro: P+Er+O
persuasivo: P+Er+S+U+As+I+V+O
paternalismo: P+At+Er+N+Al+I+S+Mo | P+At+Er+N+Al+I+Sm+O | P+At+Er+Na+Li+S+Mo | Pa+Te+Rn+Al+I+S+Mo | Pa+Te+Rn+Al+I+Sm+O
larápio: La+Ra+P+I+O
Kravtchuk: K+Ra+V+Tc+H+U+K
garbo: Ga+Rb+O
coreu: C+O+Re+U | Co+Re+U
arar: Ar+Ar
socalco: S+O+C+Al+C+O | S+O+C+Al+Co
repicar: Re+P+I+C+Ar
indirecta: I+Nd+I+Re+C+Ta
claríssimo: Cl+Ar+I+S+S+I+Mo | Cl+Ar+I+S+Si+Mo
Cabrita: Ca+Br+I+Ta
baixela: Ba+I+Xe+La
assacar: As+S+Ac+Ar
val: V+Al
Política: Po+Li+Ti+Ca | P+O+Li+Ti+Ca
lilás: Li+La+S
galanteio: Ga+La+N+Te+I+O
Francisca: F+Ra+N+C+I+S+Ca
clerical: Cl+Er+I+C+Al
Cisf: C+I+S+F
casuístico: C+As+U+I+S+Ti+C+O | Ca+S+U+I+S+Ti+C+O | C+As+U+I+S+Ti+Co | Ca+S+U+I+S+Ti+Co
baioneta: Ba+I+O+Ne+Ta
islandês: I+S+La+Nd+Es
inca: In+Ca | I+N+Ca
herético: He+Re+Ti+Co | He+Re+Ti+C+O
fariseu: F+Ar+I+S+Eu | F+Ar+I+Se+U
Esc: Es+C
Baltasar: B+Al+Ta+S+Ar
seiscentista: Se+I+S+Ce+N+Ti+S+Ta
ofegante: O+Fe+Ga+N+Te
gaiteiro: Ga+I+Te+Ir+O
espinhenses: Es+P+I+N+He+N+S+Es | Es+P+In+He+N+S+Es | Es+P+In+He+N+Se+S | Es+P+I+N+He+N+Se+S
Clio: C+Li+O | Cl+I+O
vaticínio: V+At+I+C+I+N+I+O | V+At+I+C+In+I+O | V+At+I+C+I+Ni+O
República: Re+P+U+B+Li+Ca | Re+Pu+B+Li+Ca
mondar: Mo+Nd+Ar
cristã: Cr+I+S+Ta
chic: C+H+I+C
Capra: Ca+P+Ra
bébé: Be+Be
Tenho: Te+Nh+O | Te+N+Ho | Te+N+H+O
rectificativo: Re+C+Ti+F+I+C+At+I+V+O | Re+C+Ti+F+I+Ca+Ti+V+O
raposo: Ra+Po+S+O | Ra+P+Os+O | Ra+P+O+S+O
finíssimo: F+I+N+I+S+Si+Mo | F+In+I+S+S+I+Mo | F+I+N+I+S+S+I+Mo | F+In+I+S+Si+Mo | F+I+Ni+S+Si+Mo | F+I+Ni+S+S+I+Mo
bufo: B+U+F+O
Albarran: Al+B+Ar+Ra+N
racionalismo: Ra+C+I+O+Na+Li+S+Mo | Ra+C+I+O+Na+Li+Sm+O | Ra+C+I+O+N+Al+I+Sm+O | Ra+C+I+O+N+Al+I+S+Mo
oblige: O+B+Li+Ge
nòs: N+Os | No+S | N+O+S
forense: F+O+Re+N+Se
Carneiro: C+Ar+Ne+Ir+O
Sparta: S+P+Ar+Ta
seriar: S+Er+I+Ar
Reys: Re+Y+S
paranóico: Pa+Ra+No+I+Co | Pa+Ra+N+O+I+C+O | Pa+Ra+No+I+C+O | Pa+Ra+N+O+I+Co
provocante: Pr+O+V+O+Ca+N+Te
pragal: Pr+Ag+Al
parreira: P+Ar+Re+I+Ra
bureau: B+U+Re+Au
boticário: B+O+Ti+C+Ar+I+O
Alcino: Al+C+I+N+O | Al+C+I+No | Al+C+In+O
vous: V+O+U+S
ressonar: Re+S+S+O+N+Ar
racionalista: Ra+C+I+O+Na+Li+S+Ta | Ra+C+I+O+N+Al+I+S+Ta
Cesário: Ce+S+Ar+I+O | C+Es+Ar+I+O
ascético: As+Ce+Ti+Co | As+Ce+Ti+C+O
Amato: Am+At+O
windsurf: W+I+Nd+S+U+Rf | W+I+N+Ds+U+Rf | W+In+Ds+U+Rf
teclar: Te+Cl+Ar
Suker: S+U+K+Er
sucateiro: S+U+Ca+Te+Ir+O
Luis: Lu+I+S
Liga: Li+Ga
caprino: Ca+Pr+I+No | Ca+Pr+I+N+O | Ca+Pr+In+O
vértebra: V+Er+Te+B+Ra
Passos: P+As+S+Os | Pa+S+S+O+S | P+As+S+O+S | Pa+S+S+Os
lancinante: La+N+C+I+Na+N+Te
febra: Fe+B+Ra
tecnicista: Te+C+N+I+C+I+S+Ta | Te+Cn+I+C+I+S+Ta | Te+C+Ni+C+I+S+Ta
sertã: S+Er+Ta
reclinar: Re+Cl+I+N+Ar | Re+Cl+In+Ar | Re+C+Li+N+Ar
noctívago: No+C+Ti+V+Ag+O | N+O+C+Ti+V+Ag+O
nabo: Na+B+O
hípico: H+I+P+I+Co | H+I+P+I+C+O
as: As
Versalhes: V+Er+S+Al+H+Es | V+Er+S+Al+He+S
tigela: Ti+Ge+La
obstinar: O+B+S+Ti+N+Ar
flashback: Fl+As+H+B+Ac+K | Fl+As+H+Ba+C+K | F+La+S+H+B+Ac+K | F+La+S+H+Ba+C+K
finais: F+I+Na+I+S
escabroso: Es+Ca+Br+Os+O | Es+Ca+Br+O+S+O
charlatão: C+H+Ar+La+Ta+O
Blackburn: B+La+C+K+B+U+Rn
Tete: Te+Te
possesso: P+Os+Se+S+S+O | P+Os+S+Es+S+O | Po+S+Se+S+S+O | P+O+S+Se+S+S+O | P+O+S+S+Es+S+O | Po+S+S+Es+S+O
pager: P+Ag+Er
cu: C+U | Cu
concertina: Co+N+C+Er+Ti+Na | C+O+N+C+Er+Ti+Na
am: Am
alvura: Al+V+U+Ra
revivalista: Re+V+I+V+Al+I+S+Ta
pantera: Pa+N+Te+Ra
osmose: O+Sm+O+Se | O+S+Mo+Se | Os+Mo+Se
Horn: Ho+Rn | H+O+Rn
cris: Cr+I+S
blasfemo: B+La+S+Fe+Mo
belicista: Be+Li+C+I+S+Ta
atras: At+Ra+S
Sófocles: S+O+F+O+Cl+Es
Secundário: Se+Cu+Nd+Ar+I+O | Se+C+U+Nd+Ar+I+O
repo: Re+P+O | Re+Po
Rep: Re+P
pires: P+Ir+Es | P+I+Re+S
Nobre: N+O+B+Re | No+B+Re
Estas: Es+Ta+S
Creta: C+Re+Ta
Brcko: Br+C+K+O
Bob: B+O+B
Rennes: Re+N+Ne+S | Re+N+N+Es
potássio: Po+Ta+S+S+I+O | Po+Ta+S+Si+O | P+O+Ta+S+S+I+O | P+O+Ta+S+Si+O
colaboracionista: C+O+La+B+O+Ra+C+I+O+N+I+S+Ta | Co+La+B+O+Ra+C+I+O+Ni+S+Ta | C+O+La+B+O+Ra+C+I+O+Ni+S+Ta | Co+La+B+O+Ra+C+I+O+N+I+S+Ta
coagir: C+O+Ag+Ir | Co+Ag+Ir
Ceausescu: Ce+Au+Se+Sc+U | Ce+Au+S+Es+C+U | Ce+Au+Se+S+C+U | Ce+Au+Se+S+Cu | Ce+Au+S+Es+Cu
Price: Pr+I+Ce
Lisgráfica: Li+Sg+Ra+F+I+Ca
Lierse: Li+Er+Se
infamar: I+N+F+Am+Ar | In+F+Am+Ar
Bobó: B+O+B+O
Biasion: Bi+As+I+O+N | B+I+As+I+O+N
ato: At+O
Assírio: As+S+Ir+I+O
sincretismo: Si+N+C+Re+Ti+Sm+O | S+In+C+Re+Ti+Sm+O | S+In+C+Re+Ti+S+Mo | S+I+N+C+Re+Ti+Sm+O | Si+N+C+Re+Ti+S+Mo | S+I+N+C+Re+Ti+S+Mo
prenhe: P+Re+N+He
pav: Pa+V
flop: Fl+O+P
Crisal: Cr+I+S+Al
cifrão: C+I+F+Ra+O
cepo: Ce+Po | Ce+P+O
cahir: Ca+H+Ir
Natgás: N+At+Ga+S
isca: I+S+Ca
feiticeira: Fe+I+Ti+Ce+I+Ra
clubístico: Cl+U+B+I+S+Ti+C+O | Cl+U+Bi+S+Ti+C+O | Cl+U+Bi+S+Ti+Co | Cl+U+B+I+S+Ti+Co | C+Lu+B+I+S+Ti+Co | C+Lu+B+I+S+Ti+C+O | C+Lu+Bi+S+Ti+C+O
cetáceo: Ce+Ta+Ce+O
Cagliari: C+Ag+Li+Ar+I
praceta: P+Ra+Ce+Ta
opus: O+Pu+S | O+P+U+S
nasal: N+As+Al | Na+S+Al
lácteo: La+C+Te+O
auiar: Au+I+Ar
proselitismo: Pr+O+Se+Li+Ti+S+Mo | Pr+O+Se+Li+Ti+Sm+O
parca: P+Ar+Ca
ocre: O+C+Re
fixe: F+I+Xe
atual: At+U+Al
taverna: Ta+V+Er+Na
hélice: He+Li+Ce
cunhar: Cu+N+H+Ar | C+U+N+H+Ar | Cu+Nh+Ar | C+U+Nh+Ar
calhau: C+Al+H+Au
belicoso: Be+Li+Co+S+O | Be+Li+C+Os+O | Be+Li+C+O+S+O
tipógrafo: Ti+P+Og+Ra+F+O
liberar: Li+B+Er+Ar
Lawrence: La+W+Re+N+Ce
latifundiário: La+Ti+F+U+Nd+I+Ar+I+O
Gestifundo: Ge+S+Ti+F+U+Nd+O
gesta: Ge+S+Ta
gd: Gd
conspirativo: C+O+N+S+P+I+Ra+Ti+V+O | C+O+N+S+P+Ir+At+I+V+O | Co+N+S+P+I+Ra+Ti+V+O | Co+N+S+P+Ir+At+I+V+O
canibal: Ca+N+I+B+Al | Ca+Ni+B+Al
Vós: V+Os | V+O+S
russófono: Ru+S+S+O+F+O+No | Ru+S+S+O+F+O+N+O
Popper: P+O+P+P+Er | Po+P+P+Er
hip: H+I+P
frauta: F+Ra+U+Ta | Fr+Au+Ta
esferográfica: Es+F+Er+Og+Ra+F+I+Ca
chacota: C+H+Ac+O+Ta
sikh: S+I+K+H | Si+K+H
Sete: Se+Te
server: S+Er+V+Er
refrescante: Re+F+Re+S+Ca+N+Te | Re+Fr+Es+Ca+N+Te
peruca: P+Er+U+Ca
latina: La+Ti+Na
Fogo: F+Og+O
congestão: Co+N+Ge+S+Ta+O | C+O+N+Ge+S+Ta+O
archote: Ar+C+Ho+Te | Ar+C+H+O+Te
piropo: P+Ir+O+P+O | P+Ir+O+Po
Patten: P+At+Te+N
Palatsi: P+Al+At+Si | Pa+La+Ts+I | P+Al+At+S+I
molusco: Mo+Lu+S+C+O | Mo+Lu+Sc+O | Mo+Lu+S+Co
ita: I+Ta
Francês: F+Ra+N+Ce+S | F+Ra+N+C+Es
fermosura: F+Er+Mo+S+U+Ra
cs: C+S | Cs
Carrascalão: C+Ar+Ra+S+Ca+La+O
Barata: Ba+Ra+Ta
acercar: Ac+Er+C+Ar
Reich: Re+I+C+H
Pina: P+I+Na
narcisismo: N+Ar+C+I+Si+S+Mo | N+Ar+C+I+S+I+S+Mo | N+Ar+C+I+S+I+Sm+O | N+Ar+C+I+Si+Sm+O
hop: Ho+P | H+O+P
funky: F+U+N+K+Y
espinhense: Es+P+I+N+He+N+Se | Es+P+In+He+N+Se
bulício: B+U+Li+C+I+O
Bei: Be+I
Sena: Se+Na
Salónica: S+Al+O+N+I+Ca | S+Al+O+Ni+Ca
piar: P+I+Ar
paliativo: Pa+Li+At+I+V+O | P+Al+I+At+I+V+O
Krabbe: K+Ra+B+Be
hobby: H+O+B+B+Y | Ho+B+B+Y
byte: B+Y+Te
ugandês: U+Ga+Nd+Es
sebo: Se+B+O
picaresco: P+I+Ca+Re+S+Co | P+I+Ca+Re+Sc+O | P+I+C+Ar+Es+C+O | P+I+Ca+Re+S+C+O | P+I+C+Ar+Es+Co
pantanal: Pa+N+Ta+N+Al
hipismo: H+I+P+I+Sm+O | H+I+P+I+S+Mo
Genesis: Ge+Ne+Si+S | Ge+N+Es+I+S | Ge+Ne+S+I+S
Cofina: Co+F+I+Na | C+O+F+I+Na
Careca: Ca+Re+Ca
aluir: Al+U+Ir
uivo: U+I+V+O
parvoíce: P+Ar+V+O+I+Ce
la: La
Calheiros: C+Al+He+Ir+Os | C+Al+He+Ir+O+S
soalheiro: S+O+Al+He+Ir+O
Sinai: S+I+Na+I | Si+Na+I
sauna: S+Au+Na
porfiar: Po+Rf+I+Ar | P+O+Rf+I+Ar
periclitante: P+Er+I+Cl+I+Ta+N+Te | P+Er+I+C+Li+Ta+N+Te
pagante: Pa+Ga+N+Te
Linhó: Li+N+Ho | Li+Nh+O | Li+N+H+O
interesseiro: In+Te+Re+S+Se+Ir+O | I+N+Te+Re+S+Se+Ir+O
Coopers: C+O+O+P+Er+S | Co+O+P+Er+S
celulite: Ce+Lu+Li+Te
vestiário: V+Es+Ti+Ar+I+O
Pará: Pa+Ra
morgar: Mo+Rg+Ar
morfina: Mo+Rf+I+Na
Isaura: I+S+Au+Ra
Cessna: Ce+S+S+Na | C+Es+S+Na
Bonaparte: B+O+Na+P+Ar+Te
rasar: Ra+S+Ar
Raí: Ra+I
morena: Mo+Re+Na
mg: Mg
Hagi: H+Ag+I
Forbes: F+O+Rb+Es
cosmopolitismo: C+Os+Mo+P+O+Li+Ti+Sm+O | Co+Sm+O+Po+Li+Ti+Sm+O | Co+S+Mo+Po+Li+Ti+Sm+O | C+O+S+Mo+P+O+Li+Ti+S+Mo | Co+S+Mo+Po+Li+Ti+S+Mo | Co+Sm+O+P+O+Li+Ti+S+Mo | Co+Sm+O+Po+Li+Ti+S+Mo | C+O+Sm+O+P+O+Li+Ti+Sm+O | Co+S+Mo+P+O+Li+Ti+S+Mo | C+O+Sm+O+Po+Li+Ti+S+Mo | C+Os+Mo+P+O+Li+Ti+S+Mo | Co+S+Mo+P+O+Li+Ti+Sm+O | C+O+S+Mo+P+O+Li+Ti+Sm+O | C+Os+Mo+Po+Li+Ti+Sm+O | C+O+S+Mo+Po+Li+Ti+S+Mo | C+O+Sm+O+P+O+Li+Ti+S+Mo | C+Os+Mo+Po+Li+Ti+S+Mo
camiseiro: C+Am+I+Se+Ir+O
bambo: B+Am+B+O
Amo: Am+O
profundas: Pr+O+F+U+Nd+As
neoclássico: Ne+O+Cl+As+S+I+Co | Ne+O+C+La+S+S+I+Co | Ne+O+Cl+As+S+I+C+O | Ne+O+Cl+As+Si+Co | Ne+O+C+La+S+Si+Co | Ne+O+C+La+S+S+I+C+O | Ne+O+C+La+S+Si+C+O | Ne+O+Cl+As+Si+C+O
âmbar: Am+B+Ar
Irvine: Ir+V+I+Ne
hélio: He+Li+O
cesta: Ce+S+Ta | C+Es+Ta
catar: C+At+Ar
canavial: Ca+Na+V+I+Al
Bernstein: Be+Rn+S+Te+I+N | Be+Rn+S+Te+In | B+Er+N+S+Te+In
You: Y+O+U
Tina: Ti+Na
rutilante: Ru+Ti+La+N+Te
refresco: Re+Fr+Es+C+O | Re+F+Re+S+Co | Re+Fr+Es+Co | Re+F+Re+S+C+O | Re+F+Re+Sc+O
Pois: Po+I+S | P+O+I+S
Ofir: O+F+Ir
lúbrico: Lu+Br+I+C+O | Lu+Br+I+Co
Essen: Es+Se+N
cigana: C+I+Ga+Na
caritativo: C+Ar+I+Ta+Ti+V+O
Sukarno: S+U+K+Ar+No | S+U+K+Ar+N+O
Sauber: S+Au+B+Er
psicanalítico: P+S+I+Ca+Na+Li+Ti+Co | P+Si+Ca+N+Al+I+Ti+C+O | P+Si+Ca+Na+Li+Ti+C+O | P+S+I+Ca+N+Al+I+Ti+Co | P+Si+Ca+N+Al+I+Ti+Co | P+S+I+Ca+N+Al+I+Ti+C+O | P+Si+Ca+Na+Li+Ti+Co | P+S+I+Ca+Na+Li+Ti+C+O
Pinheiro: P+In+He+Ir+O | P+I+N+He+Ir+O
palpar: P+Al+P+Ar
Outão: O+U+Ta+O
Kivu: K+I+V+U
Falcone: F+Al+C+O+Ne | F+Al+Co+Ne
círio: C+Ir+I+O
bambu: B+Am+B+U
Seu: Se+U | S+Eu
Narana: Na+Ra+Na
inactivo: I+Na+C+Ti+V+O | In+Ac+Ti+V+O | I+N+Ac+Ti+V+O
ciclópico: C+I+Cl+O+P+I+Co | C+I+Cl+O+P+I+C+O
ce: Ce
Barcarena: B+Ar+Ca+Re+Na
arrendatário: Ar+Re+Nd+At+Ar+I+O
alcorão: Al+C+O+Ra+O | Al+Co+Ra+O
viscoso: V+I+S+C+O+S+O | V+I+Sc+Os+O | V+I+S+C+Os+O | V+I+Sc+O+S+O | V+I+S+Co+S+O
Teu: Te+U
Tanta: Ta+N+Ta
sub: S+U+B
rúbrica: Ru+Br+I+Ca
prontificar: Pr+O+N+Ti+F+I+C+Ar
Oikos: O+I+K+Os | O+I+K+O+S
novinho: N+O+V+In+H+O | No+V+In+Ho | No+V+In+H+O | No+V+I+N+H+O | No+V+I+Nh+O | No+V+I+N+Ho | N+O+V+I+Nh+O | N+O+V+I+N+Ho | N+O+V+In+Ho | N+O+V+I+N+H+O
Nehru: Ne+H+Ru
libré: Li+B+Re
Ibsen: I+B+Se+N
fosfato: F+O+S+F+At+O | F+Os+F+At+O
florentino: Fl+O+Re+N+Ti+N+O | Fl+O+Re+N+Ti+No
artificioso: Ar+Ti+F+I+C+I+O+S+O | Ar+Ti+F+I+C+I+Os+O
Vargas: V+Ar+Ga+S
Sta: S+Ta
sebenta: Se+Be+N+Ta
monteiro: Mo+N+Te+Ir+O
Burgos: B+U+Rg+O+S | B+U+Rg+Os
barraco: B+Ar+Ra+C+O | B+Ar+Ra+Co
Bahamas: Ba+H+Am+As
yes: Y+Es
Salinas: S+Al+I+N+As | S+Al+In+As | S+Al+I+Na+S
Polanski: Po+La+N+S+K+I | P+O+La+N+S+K+I
Nabão: Na+Ba+O
ci: C+I
Black: B+La+C+K
placar: P+La+C+Ar
patos: P+At+Os | P+At+O+S
cábula: Ca+B+U+La
búfalo: B+U+F+Al+O
amaciar: Am+Ac+I+Ar
that: Th+At
ten: Te+N
subavaliar: S+U+Ba+V+Al+I+Ar
silicone: Si+Li+Co+Ne | S+I+Li+C+O+Ne | Si+Li+C+O+Ne | S+I+Li+Co+Ne
rasteira: Ra+S+Te+I+Ra
preparo: P+Re+P+Ar+O
Pierce: P+I+Er+Ce
pantanoso: Pa+N+Ta+N+O+S+O | Pa+N+Ta+N+Os+O | Pa+N+Ta+No+S+O
Pandora: Pa+Nd+O+Ra
Nero: N+Er+O
mon: Mo+N
Caminho: C+Am+I+Nh+O | C+Am+I+N+H+O | C+Am+In+Ho | C+Am+In+H+O | C+Am+I+N+Ho
boer: B+O+Er
besteiro: B+Es+Te+Ir+O | Be+S+Te+Ir+O
assistencial: As+Si+S+Te+N+C+I+Al | As+S+I+S+Te+N+C+I+Al
Vialli: V+I+Al+Li
retinir: Re+Ti+N+Ir
recife: Re+C+I+Fe
parteira: P+Ar+Te+I+Ra
converso: C+O+N+V+Er+S+O | Co+N+V+Er+S+O
catana: Ca+Ta+Na
carrear: C+Ar+Re+Ar
Sis: S+I+S | Si+S
reocupar: Re+O+Cu+P+Ar | Re+O+C+U+P+Ar
Pinho: P+In+Ho | P+I+N+H+O | P+I+N+Ho | P+In+H+O | P+I+Nh+O
online: O+N+Li+Ne
moita: Mo+I+Ta
Life: Li+Fe
ganso: Ga+N+S+O
fonético: F+O+Ne+Ti+Co | F+O+Ne+Ti+C+O
Feirense: Fe+I+Re+N+Se
cl: Cl
Cinco: C+I+N+Co | C+I+N+C+O | C+In+Co | C+In+C+O
catre: C+At+Re
assoprar: As+S+O+Pr+Ar
professo: Pr+O+Fe+S+S+O | Pr+O+F+Es+S+O
certinho: C+Er+Ti+N+H+O | C+Er+Ti+Nh+O | C+Er+Ti+N+Ho
socar: S+O+C+Ar
officio: O+F+F+I+C+I+O
lisura: Li+S+U+Ra
champagne: C+H+Am+P+Ag+Ne
barbatana: B+Ar+Ba+Ta+Na
Américo: Am+Er+I+C+O | Am+Er+I+Co
tinir: Ti+N+Ir
Perth: P+Er+Th
Gaúcho: Ga+U+C+H+O | Ga+U+C+Ho
Breves: B+Re+V+Es
Boban: B+O+Ba+N
Timóteo: Ti+Mo+Te+O
rufar: Ru+F+Ar
ouuer: O+U+U+Er
Inô: In+O | I+N+O | I+No
Fischer: F+I+Sc+H+Er | F+I+S+C+H+Er
Eunice: Eu+N+I+Ce | Eu+Ni+Ce
esfinge: Es+F+In+Ge | Es+F+I+N+Ge
bronca: Br+O+N+Ca
tan: Ta+N
recalcar: Re+C+Al+C+Ar
Clippers: Cl+I+P+P+Er+S | C+Li+P+P+Er+S
breviário: B+Re+V+I+Ar+I+O
soffrer: S+O+F+Fr+Er
revisteiro: Re+V+I+S+Te+Ir+O
Calvin: C+Al+V+I+N | Ca+Lv+I+N | Ca+Lv+In | C+Al+V+In
arrear: Ar+Re+Ar
Agusta: Ag+U+S+Ta
agoiro: Ag+O+Ir+O
Vila: V+I+La
tecno: Te+C+No | Te+C+N+O | Te+Cn+O
sineta: S+I+Ne+Ta | Si+Ne+Ta
Samouco: S+Am+O+U+C+O | S+Am+O+U+Co
Íris: Ir+I+S
pt: Pt
piroso: P+Ir+Os+O | P+Ir+O+S+O
ovacionar: O+V+Ac+I+O+N+Ar
moiro: Mo+Ir+O
incluíndo: I+N+Cl+U+I+Nd+O | I+N+C+Lu+I+Nd+O | In+Cl+U+I+Nd+O | In+C+Lu+I+Nd+O
Fagundes: F+Ag+U+Nd+Es
cr: Cr
clonar: Cl+O+N+Ar
Carta: C+Ar+Ta
Brunei: Br+U+Ne+I | B+Ru+Ne+I
Bruce: Br+U+Ce | B+Ru+Ce
script: S+Cr+I+Pt
rabeca: Ra+Be+Ca
monegasco: Mo+Ne+Ga+S+Co | Mo+Ne+Ga+Sc+O | Mo+Ne+Ga+S+C+O
cossaco: C+Os+S+Ac+O | C+O+S+S+Ac+O | Co+S+S+Ac+O
Cooperativo: C+O+O+P+Er+At+I+V+O | Co+O+P+Er+At+I+V+O
Canon: Ca+No+N | Ca+N+O+N
alvorecer: Al+V+O+Re+C+Er
tendinite: Te+Nd+In+I+Te | Te+Nd+I+Ni+Te | Te+Nd+I+N+I+Te
relativismo: Re+La+Ti+V+I+Sm+O | Re+La+Ti+V+I+S+Mo
Ratinho: Ra+Ti+Nh+O | Ra+Ti+N+H+O | Ra+Ti+N+Ho
land: La+Nd
fontanário: F+O+N+Ta+N+Ar+I+O
Finibanco: F+In+I+Ba+N+Co | F+In+I+Ba+N+C+O | F+I+Ni+Ba+N+Co | F+I+N+I+Ba+N+Co | F+I+N+I+Ba+N+C+O | F+I+Ni+Ba+N+C+O
coxear: C+O+Xe+Ar | Co+Xe+Ar
cochichar: Co+C+H+I+C+H+Ar | C+O+C+H+I+C+H+Ar
Albacete: Al+Ba+Ce+Te
Unisys: U+Ni+S+Y+S | U+N+I+S+Y+S
recrear: Re+C+Re+Ar
protestantismo: Pr+O+Te+S+Ta+N+Ti+Sm+O | Pr+O+Te+S+Ta+N+Ti+S+Mo
prefaciar: P+Re+F+Ac+I+Ar
Playstation: P+La+Y+S+Ta+Ti+O+N
Montes: Mo+N+Te+S
latifúndio: La+Ti+F+U+Nd+I+O
isolacionista: I+S+O+La+C+I+O+Ni+S+Ta | I+S+O+La+C+I+O+N+I+S+Ta
indigestão: I+Nd+I+Ge+S+Ta+O
hein: He+In | He+I+N
fluorescente: F+Lu+O+Re+S+Ce+N+Te | Fl+U+O+Re+S+Ce+N+Te
sn: S+N | Sn
Sion: S+I+O+N | Si+O+N
rabino: Ra+B+I+N+O | Ra+B+In+O | Ra+Bi+No | Ra+B+I+No | Ra+Bi+N+O
procela: Pr+O+Ce+La
Ouattara: O+U+At+Ta+Ra
nepotismo: Ne+Po+Ti+Sm+O | Ne+P+O+Ti+S+Mo | Ne+Po+Ti+S+Mo | Ne+P+O+Ti+Sm+O
foyer: F+O+Y+Er
fincar: F+In+C+Ar | F+I+N+C+Ar
cós: Co+S | C+Os | C+O+S
asséptico: As+Se+P+Ti+C+O | As+Se+Pt+I+C+O | As+Se+P+Ti+Co | As+Se+Pt+I+Co
amorfo: Am+O+Rf+O
alucinar: Al+U+C+I+N+Ar | Al+U+C+In+Ar
valeroso: V+Al+Er+Os+O | V+Al+Er+O+S+O
positivismo: Po+Si+Ti+V+I+S+Mo | Po+Si+Ti+V+I+Sm+O | P+Os+I+Ti+V+I+Sm+O | P+O+Si+Ti+V+I+Sm+O | P+O+S+I+Ti+V+I+Sm+O | P+Os+I+Ti+V+I+S+Mo | P+O+Si+Ti+V+I+S+Mo | P+O+S+I+Ti+V+I+S+Mo | Po+S+I+Ti+V+I+Sm+O | Po+S+I+Ti+V+I+S+Mo
Lara: La+Ra
Ivo: I+V+O
Fernão: F+Er+Na+O
Eric: Er+I+C
convalescer: Co+N+V+Al+Es+C+Er | C+O+N+V+Al+Es+C+Er
ceramista: C+Er+Am+I+S+Ta
carburante: C+Ar+B+U+Ra+N+Te | Ca+Rb+U+Ra+N+Te
Plano: P+La+No | P+La+N+O
Orense: O+Re+N+Se
Natura: N+At+U+Ra
Luisinho: Lu+I+S+I+Nh+O | Lu+I+S+In+Ho | Lu+I+S+I+N+Ho | Lu+I+Si+N+H+O | Lu+I+Si+N+Ho | Lu+I+Si+Nh+O | Lu+I+S+I+N+H+O | Lu+I+S+In+H+O
Huíla: H+U+I+La
flautista: F+La+U+Ti+S+Ta | Fl+Au+Ti+S+Ta
Filipa: F+I+Li+Pa
bip: B+I+P | Bi+P
vau: V+Au
pin: P+In | P+I+N
fatalista: F+At+Al+I+S+Ta
Chippo: C+H+I+P+Po | C+H+I+P+P+O
canarinho: Ca+N+Ar+In+Ho | Ca+N+Ar+I+N+H+O | Ca+N+Ar+In+H+O | Ca+N+Ar+I+N+Ho | Ca+N+Ar+I+Nh+O
Branca: B+Ra+N+Ca
arnês: Ar+Ne+S | Ar+N+Es
Arco: Ar+C+O | Ar+Co
sey: Se+Y
parenta: Pa+Re+N+Ta
inteirinho: In+Te+Ir+In+H+O | In+Te+Ir+I+N+H+O | In+Te+Ir+In+Ho | I+N+Te+Ir+In+Ho | In+Te+Ir+I+Nh+O | I+N+Te+Ir+I+N+H+O | I+N+Te+Ir+In+H+O | I+N+Te+Ir+I+Nh+O
fender: Fe+Nd+Er
cavalinho: Ca+V+Al+I+N+Ho | Ca+V+Al+I+Nh+O | Ca+V+Al+In+H+O | Ca+V+Al+I+N+H+O | Ca+V+Al+In+Ho
agnóstico: Ag+N+O+S+Ti+Co | Ag+N+O+S+Ti+C+O | Ag+N+Os+Ti+C+O | Ag+No+S+Ti+Co | Ag+No+S+Ti+C+O
Vitesse: V+I+Te+S+Se
Un: U+N
Taira: Ta+I+Ra
Cáritas: C+Ar+I+Ta+S
cash: Ca+S+H | C+As+H
bufete: B+U+Fe+Te
Boss: B+Os+S | B+O+S+S
titânico: Ti+Ta+Ni+Co | Ti+Ta+Ni+C+O | Ti+Ta+N+I+C+O | Ti+Ta+N+I+Co
sionismo: Si+O+Ni+S+Mo | Si+O+Ni+Sm+O | S+I+O+Ni+Sm+O | Si+O+N+I+Sm+O | S+I+O+N+I+S+Mo | S+I+O+Ni+S+Mo | Si+O+N+I+S+Mo | S+I+O+N+I+Sm+O
propano: Pr+O+Pa+No | Pr+O+Pa+N+O
Parece: Pa+Re+Ce
Nené: Ne+Ne
cãs: C+As | Ca+S
àcerco: Ac+Er+C+O | Ac+Er+Co
Callas: C+Al+La+S
bronco: Br+O+N+C+O | Br+O+N+Co
Bilro: Bi+Lr+O | B+I+Lr+O
alcantarense: Al+Ca+N+Ta+Re+N+Se
sineiro: Si+Ne+Ir+O | S+I+Ne+Ir+O
Rao: Ra+O
positivista: Po+Si+Ti+V+I+S+Ta | P+Os+I+Ti+V+I+S+Ta | P+O+Si+Ti+V+I+S+Ta | Po+S+I+Ti+V+I+S+Ta | P+O+S+I+Ti+V+I+S+Ta
narina: N+Ar+I+Na
lasso: La+S+S+O
hir: H+Ir
gelatina: Ge+La+Ti+Na
fusta: F+U+S+Ta
Estes: Es+Te+S
Copacabana: C+O+Pa+Ca+Ba+Na | Co+Pa+Ca+Ba+Na
Cocteau: Co+C+Te+Au | C+O+C+Te+Au
Chagas: C+H+Ag+As
cambiar: C+Am+B+I+Ar | C+Am+Bi+Ar
bago: B+Ag+O
aro: Ar+O
tiber: Ti+B+Er
rafeiro: Ra+Fe+Ir+O
Polisário: P+O+Li+S+Ar+I+O | Po+Li+S+Ar+I+O
Plutão: P+Lu+Ta+O
pioneirismo: P+I+O+Ne+Ir+I+Sm+O | P+I+O+Ne+Ir+I+S+Mo
parra: P+Ar+Ra
Início: I+Ni+C+I+O | I+N+I+C+I+O | In+I+C+I+O
incensar: In+Ce+N+S+Ar | I+N+Ce+N+S+Ar
ilusionista: I+Lu+S+I+O+Ni+S+Ta | I+Lu+Si+O+Ni+S+Ta | I+Lu+Si+O+N+I+S+Ta | I+Lu+S+I+O+N+I+S+Ta
ilusionismo: I+Lu+S+I+O+Ni+S+Mo | I+Lu+Si+O+N+I+S+Mo | I+Lu+S+I+O+N+I+Sm+O | I+Lu+S+I+O+Ni+Sm+O | I+Lu+Si+O+Ni+S+Mo | I+Lu+Si+O+Ni+Sm+O | I+Lu+Si+O+N+I+Sm+O | I+Lu+S+I+O+N+I+S+Mo
Gestapo: Ge+S+Ta+P+O | Ge+S+Ta+Po
Fontenay: F+O+N+Te+Na+Y
Bihé: B+I+He | Bi+He
balancear: Ba+La+N+Ce+Ar
viso: V+I+S+O
Ste: S+Te
Sharif: S+H+Ar+I+F
rendoso: Re+Nd+O+S+O | Re+Nd+Os+O
poer: Po+Er | P+O+Er
pesaroso: P+Es+Ar+O+S+O | P+Es+Ar+Os+O
Monserrate: Mo+N+S+Er+Ra+Te
McKiernan: Mc+K+I+Er+Na+N
Knin: K+N+I+N | K+N+In | K+Ni+N
floco: Fl+O+Co | Fl+O+C+O
estendal: Es+Te+Nd+Al
ativo: At+I+V+O
yo: Y+O
vagina: V+Ag+I+Na
Séneca: Se+Ne+Ca
pareceo: Pa+Re+Ce+O
Cronenberg: Cr+O+Ne+N+Be+Rg
caracara: Ca+Ra+Ca+Ra
Bola: B+O+La
Barak: Ba+Ra+K
arcano: Ar+Ca+N+O | Ar+Ca+No
revisionista: Re+V+I+Si+O+Ni+S+Ta | Re+V+I+Si+O+N+I+S+Ta | Re+V+I+S+I+O+N+I+S+Ta | Re+V+I+S+I+O+Ni+S+Ta
patogênico: P+At+O+Ge+Ni+C+O | P+At+O+Ge+N+I+Co | P+At+O+Ge+N+I+C+O | P+At+O+Ge+Ni+Co
monolítico: Mo+No+Li+Ti+C+O | Mo+No+Li+Ti+Co | Mo+N+O+Li+Ti+C+O | Mo+N+O+Li+Ti+Co
how: H+O+W | Ho+W
herpes: H+Er+P+Es
Fe: Fe
Condestá: C+O+Nd+Es+Ta | Co+Nd+Es+Ta
coice: Co+I+Ce | C+O+I+Ce
Calvino: Ca+Lv+I+N+O | C+Al+V+I+No | Ca+Lv+In+O | C+Al+V+In+O | Ca+Lv+I+No | C+Al+V+I+N+O
Rubens: Ru+Be+N+S
placebo: P+La+Ce+B+O
Pinerfo: P+I+N+Er+F+O | P+In+Er+F+O | P+I+Ne+Rf+O
Lúcio: Lu+C+I+O
Iliescu: I+Li+Es+Cu | I+Li+Es+C+U
confessionário: Co+N+F+Es+S+I+O+N+Ar+I+O | C+O+N+F+Es+Si+O+N+Ar+I+O | C+O+N+Fe+S+S+I+O+N+Ar+I+O | C+O+N+F+Es+S+I+O+N+Ar+I+O | Co+N+Fe+S+Si+O+N+Ar+I+O | Co+N+F+Es+Si+O+N+Ar+I+O | C+O+N+Fe+S+Si+O+N+Ar+I+O
cFC: Cf+C | C+F+C
bramar: Br+Am+Ar
tatear: Ta+Te+Ar
refratário: Re+Fr+At+Ar+I+O
Plavsic: P+La+V+Si+C | P+La+V+S+I+C
Pataias: Pa+Ta+I+As
palá: Pa+La
contender: Co+N+Te+Nd+Er | C+O+N+Te+Nd+Er
côncavo: Co+N+Ca+V+O | C+O+N+Ca+V+O
balofo: B+Al+O+F+O
Aurélio: Au+Re+Li+O
Siga: S+I+Ga | Si+Ga
rasgão: Ra+S+Ga+O
Poiares: P+O+I+Ar+Es | Po+I+Ar+Es
pina: P+I+Na
monográfico: Mo+N+Og+Ra+F+I+Co | Mo+N+Og+Ra+F+I+C+O
luterano: Lu+Te+Ra+No | Lu+Te+Ra+N+O
Crossfire: Cr+O+S+S+F+I+Re | Cr+Os+S+F+I+Re
Bonino: B+O+Ni+No | B+O+N+I+No | B+O+N+In+O | B+O+N+I+N+O | B+O+Ni+N+O
berrante: B+Er+Ra+N+Te
Bambo: B+Am+B+O
acne: Ac+Ne
Smiths: Sm+I+Th+S
silvo: S+I+Lv+O | Si+Lv+O
Rus: Ru+S
picareta: P+I+Ca+Re+Ta
fracionar: F+Ra+C+I+O+N+Ar | Fr+Ac+I+O+N+Ar
fiesta: F+I+Es+Ta
crustáceo: C+Ru+S+Ta+Ce+O | Cr+U+S+Ta+Ce+O
chauvinismo: C+H+Au+V+In+I+Sm+O | C+H+Au+V+I+Ni+S+Mo | C+H+Au+V+I+N+I+Sm+O | C+H+Au+V+I+N+I+S+Mo | C+H+Au+V+I+Ni+Sm+O | C+H+Au+V+In+I+S+Mo
cervical: C+Er+V+I+C+Al
Aus: Au+S
tirante: Ti+Ra+N+Te
ondulante: O+Nd+U+La+N+Te
Libra: Li+B+Ra
hoc: H+O+C | Ho+C
espinal: Es+P+In+Al | Es+P+I+N+Al
Chostakovitch: C+H+Os+Ta+K+O+V+I+Tc+H | C+Ho+S+Ta+K+O+V+I+Tc+H | C+H+O+S+Ta+K+O+V+I+Tc+H
Ceo: Ce+O
Ban: Ba+N
very: V+Er+Y
persona: P+Er+S+O+Na
pausar: Pa+U+S+Ar | P+Au+S+Ar
moralismo: Mo+Ra+Li+S+Mo | Mo+Ra+Li+Sm+O
montepio: Mo+N+Te+P+I+O
Koch: K+O+C+H
chacinar: C+H+Ac+In+Ar | C+H+Ac+I+N+Ar
Catherine: Ca+Th+Er+I+Ne | C+At+H+Er+I+Ne
camaronês: C+Am+Ar+O+N+Es | C+Am+Ar+O+Ne+S
Bonga: B+O+N+Ga
auer: Au+Er
vesícula: V+Es+I+Cu+La | V+Es+I+C+U+La
srs: Sr+S
Sierra: Si+Er+Ra | S+I+Er+Ra
Sheraton: S+H+Er+At+O+N
Resnais: Re+S+Na+I+S
Farias: F+Ar+I+As
esp: Es+P
cibernético: C+I+B+Er+Ne+Ti+Co | C+I+B+Er+Ne+Ti+C+O
cEO: Ce+O
Camacho: C+Am+Ac+H+O | C+Am+Ac+Ho
assear: As+Se+Ar
rendar: Re+Nd+Ar
Proteste: Pr+O+Te+S+Te
oscilante: Os+C+I+La+N+Te | O+Sc+I+La+N+Te | O+S+C+I+La+N+Te
lunático: Lu+Na+Ti+Co | Lu+N+At+I+C+O | Lu+N+At+I+Co | Lu+Na+Ti+C+O
Fnac: F+N+Ac | F+Na+C
calote: C+Al+O+Te
Butler: B+U+Tl+Er
baga: Ba+Ga
suástica: S+U+As+Ti+Ca
sarauis: S+Ar+Au+I+S
Profissional: Pr+O+F+I+S+S+I+O+N+Al | Pr+O+F+I+S+Si+O+N+Al
Nereu: N+Er+Eu | Ne+Re+U
Nasoni: Na+S+O+N+I | Na+S+O+Ni | N+As+O+N+I | N+As+O+Ni
confinante: C+O+N+F+I+Na+N+Te | Co+N+F+I+Na+N+Te
cheo: C+He+O
brevíssimo: B+Re+V+I+S+S+I+Mo | B+Re+V+I+S+Si+Mo
Bobby: B+O+B+B+Y
biscate: B+I+S+Ca+Te | Bi+S+Ca+Te
Waco: W+Ac+O
stico: S+Ti+Co | S+Ti+C+O
Senhores: Se+N+Ho+Re+S | Se+N+H+O+Re+S | Se+Nh+O+Re+S
relacional: Re+La+C+I+O+N+Al
percussivo: P+Er+Cu+S+S+I+V+O | P+Er+Cu+S+Si+V+O | P+Er+C+U+S+Si+V+O | P+Er+C+U+S+S+I+V+O
nec: Ne+C
Luso: Lu+S+O
gaúcho: Ga+U+C+H+O | Ga+U+C+Ho
frutífero: Fr+U+Ti+F+Er+O | F+Ru+Ti+F+Er+O
feérico: Fe+Er+I+Co | Fe+Er+I+C+O
cros: Cr+O+S | Cr+Os
baba: Ba+Ba
tacão: Ta+Ca+O
revirar: Re+V+Ir+Ar
Putin: P+U+Ti+N | Pu+Ti+N
Mónica: Mo+N+I+Ca | Mo+Ni+Ca
internacionalismo: In+Te+Rn+Ac+I+O+N+Al+I+Sm+O | I+N+Te+Rn+Ac+I+O+N+Al+I+Sm+O | In+Te+Rn+Ac+I+O+Na+Li+S+Mo | I+N+Te+Rn+Ac+I+O+N+Al+I+S+Mo | I+N+Te+Rn+Ac+I+O+Na+Li+S+Mo | In+Te+Rn+Ac+I+O+N+Al+I+S+Mo | I+N+Te+Rn+Ac+I+O+Na+Li+Sm+O | In+Te+Rn+Ac+I+O+Na+Li+Sm+O
Festa: Fe+S+Ta | F+Es+Ta
chauvinista: C+H+Au+V+I+N+I+S+Ta | C+H+Au+V+In+I+S+Ta | C+H+Au+V+I+Ni+S+Ta
Bucks: B+U+C+K+S
ater: At+Er
tirana: Ti+Ra+Na
Samper: S+Am+P+Er
panar: Pa+N+Ar
McCoy: Mc+C+O+Y | Mc+Co+Y
liv: Li+V
lady: La+Dy
inoperacional: In+O+P+Er+Ac+I+O+N+Al | I+N+O+P+Er+Ac+I+O+N+Al | I+No+P+Er+Ac+I+O+N+Al
genovês: Ge+No+V+Es | Ge+N+O+V+Es
gaiato: Ga+I+At+O
espinafre: Es+P+I+Na+F+Re
Carmona: C+Ar+Mo+Na
Vinicius: V+I+N+I+C+I+U+S | V+In+I+C+I+U+S | V+I+Ni+C+I+U+S
tísico: Ti+S+I+C+O | Ti+Si+C+O | Ti+S+I+Co | Ti+Si+Co
Shas: S+H+As
session: Se+S+S+I+O+N | S+Es+S+I+O+N | S+Es+Si+O+N | Se+S+Si+O+N
page: Pa+Ge
nonsense: N+O+N+Se+N+Se | No+N+Se+N+Se
nesga: Ne+S+Ga | N+Es+Ga
Lapa: La+Pa
Ihe: I+He
hierático: H+I+Er+At+I+C+O | H+I+Er+At+I+Co
Génio: Ge+N+I+O | Ge+Ni+O
Flávio: F+La+V+I+O
clavícula: C+La+V+I+Cu+La | C+La+V+I+C+U+La
cerealífero: Ce+Re+Al+I+F+Er+O
carte: C+Ar+Te
sovar: S+O+V+Ar
sibilino: Si+Bi+Li+N+O | S+I+B+I+Li+N+O | Si+B+I+Li+No | S+I+B+I+Li+No | S+I+Bi+Li+No | S+I+Bi+Li+N+O | Si+Bi+Li+No | Si+B+I+Li+N+O
Regente: Re+Ge+N+Te
pornô: Po+Rn+O | P+O+Rn+O
pericial: P+Er+I+C+I+Al
peúga: P+Eu+Ga
Panasonic: Pa+N+As+O+N+I+C | Pa+Na+S+O+N+I+C | Pa+Na+S+O+Ni+C | Pa+N+As+O+Ni+C
oscar: Os+C+Ar | O+S+C+Ar | O+Sc+Ar
Icep: I+Ce+P
Furnas: F+U+Rn+As
cubana: C+U+Ba+Na | Cu+Ba+Na
Contas: Co+N+Ta+S | C+O+N+Ta+S
Berg: Be+Rg
talão: Ta+La+O
tê: Te
Republica: Re+P+U+B+Li+Ca | Re+Pu+B+Li+Ca
Protali: Pr+O+Ta+Li
Plínio: P+Li+N+I+O | P+Li+Ni+O
pd: Pd
Gav: Ga+V
Fronteira: Fr+O+N+Te+I+Ra
fenecer: Fe+Ne+C+Er
cubista: C+U+B+I+S+Ta | C+U+Bi+S+Ta | Cu+B+I+S+Ta | Cu+Bi+S+Ta
cercanias: C+Er+Ca+N+I+As | C+Er+Ca+Ni+As
Buarcos: B+U+Ar+C+Os | B+U+Ar+Co+S | B+U+Ar+C+O+S
Bayreuth: Ba+Y+Re+U+Th
Austin: Au+S+Ti+N
Vogts: V+Og+Ts
Tabucchi: Ta+B+U+C+C+H+I
puré: Pu+Re | P+U+Re
Prosiurb: Pr+O+S+I+U+Rb | Pr+O+Si+U+Rb | Pr+Os+I+U+Rb
Moreno: Mo+Re+No | Mo+Re+N+O
Fauré: F+Au+Re
carvalhal: C+Ar+V+Al+H+Al
Boticas: B+O+Ti+C+As | B+O+Ti+Ca+S
Bismarck: Bi+Sm+Ar+C+K | B+I+Sm+Ar+C+K
tipográfico: Ti+P+Og+Ra+F+I+C+O | Ti+P+Og+Ra+F+I+Co
thi: Th+I
Shearer: S+He+Ar+Er
repisar: Re+P+I+S+Ar
píncaro: P+I+N+C+Ar+O | P+In+C+Ar+O
Chubais: C+H+U+Ba+I+S
Carachi: Ca+Ra+C+H+I | C+Ar+Ac+H+I
calcio: C+Al+C+I+O
beliche: Be+Li+C+He
Balbina: B+Al+B+I+Na | B+Al+Bi+Na
senhorear: Se+Nh+O+Re+Ar | Se+N+H+O+Re+Ar | Se+N+Ho+Re+Ar
Punisic: Pu+N+I+S+I+C | Pu+Ni+Si+C | P+U+N+I+Si+C | P+U+N+I+S+I+C | P+U+Ni+Si+C | Pu+N+I+Si+C | Pu+Ni+S+I+C
pan: Pa+N
Orange: O+Ra+N+Ge
neolítico: Ne+O+Li+Ti+Co | Ne+O+Li+Ti+C+O
Liberato: Li+B+Er+At+O
Eugenio: Eu+Ge+N+I+O | Eu+Ge+Ni+O
escrutinar: Es+Cr+U+Ti+N+Ar | Es+C+Ru+Ti+N+Ar
calculismo: C+Al+Cu+Li+S+Mo | C+Al+C+U+Li+Sm+O | C+Al+C+U+Li+S+Mo | C+Al+Cu+Li+Sm+O
arbóreo: Ar+B+O+Re+O
Voynov: V+O+Y+N+O+V | V+O+Y+No+V
Valério: V+Al+Er+I+O
reinvindicar: Re+I+N+V+I+Nd+I+C+Ar | Re+In+V+I+Nd+I+C+Ar
recobrir: Re+C+O+Br+Ir | Re+Co+Br+Ir
mousse: Mo+U+S+Se
Lindoso: Li+Nd+O+S+O | Li+Nd+Os+O
húngara: H+U+N+Ga+Ra
fulvo: F+U+Lv+O
fálico: F+Al+I+C+O | F+Al+I+Co
confisco: C+O+N+F+I+S+Co | Co+N+F+I+S+C+O | C+O+N+F+I+Sc+O | C+O+N+F+I+S+C+O | Co+N+F+I+S+Co | Co+N+F+I+Sc+O
titã: Ti+Ta
tarefeiro: Ta+Re+Fe+Ir+O
sereníssimo: Se+Re+N+I+S+Si+Mo | Se+Re+N+I+S+S+I+Mo | Se+Re+Ni+S+S+I+Mo | Se+Re+Ni+S+Si+Mo
prumo: P+Ru+Mo | Pr+U+Mo
polas: P+O+La+S | Po+La+S
Parabéns: Pa+Ra+Be+N+S
galinheiro: Ga+Li+N+He+Ir+O
frasear: F+Ra+Se+Ar
Fnam: F+N+Am
florete: Fl+O+Re+Te
cincar: C+In+C+Ar | C+I+N+C+Ar
ben: Be+N
Aghini: Ag+H+In+I | Ag+H+I+Ni | Ag+H+I+N+I
Stern: S+Te+Rn
Ruas: Ru+As
reboco: Re+B+O+Co | Re+B+O+C+O
peronista: P+Er+O+Ni+S+Ta | P+Er+O+N+I+S+Ta
Linhares: Li+Nh+Ar+Es | Li+N+H+Ar+Es
hospício: Ho+S+P+I+C+I+O | H+Os+P+I+C+I+O | H+O+S+P+I+C+I+O
ficcionista: F+I+C+C+I+O+Ni+S+Ta | F+I+C+C+I+O+N+I+S+Ta
errático: Er+Ra+Ti+Co | Er+Ra+Ti+C+O
Cresson: Cr+Es+S+O+N | C+Re+S+S+O+N
cover: Co+V+Er | C+O+V+Er
choupana: C+H+O+U+Pa+Na | C+Ho+U+Pa+Na
celibatário: Ce+Li+B+At+Ar+I+O
cavernoso: Ca+V+Er+N+O+S+O | Ca+V+Er+N+Os+O | Ca+V+Er+No+S+O
artificialismo: Ar+Ti+F+I+C+I+Al+I+Sm+O | Ar+Ti+F+I+C+I+Al+I+S+Mo
vocacional: V+O+C+Ac+I+O+N+Al | V+O+Ca+C+I+O+N+Al
tara: Ta+Ra
sarauí: S+Ar+Au+I
pita: P+I+Ta
natura: N+At+U+Ra
Monica: Mo+N+I+Ca | Mo+Ni+Ca
Espanhas: Es+Pa+N+H+As | Es+Pa+Nh+As
clown: Cl+O+W+N
chocalho: C+H+O+C+Al+H+O | C+H+O+C+Al+Ho | C+Ho+C+Al+Ho | C+Ho+C+Al+H+O
campino: C+Am+P+I+No | C+Am+P+In+O | C+Am+P+I+N+O
tablier: Ta+B+Li+Er
Reservas: Re+S+Er+V+As
ratio: Ra+Ti+O
Políticas: Po+Li+Ti+C+As | P+O+Li+Ti+Ca+S | P+O+Li+Ti+C+As | Po+Li+Ti+Ca+S
Pero: P+Er+O
pícaro: P+I+C+Ar+O
parassocial: Pa+Ra+S+S+O+C+I+Al | P+Ar+As+S+O+C+I+Al
palrar: Pa+Lr+Ar
moura: Mo+U+Ra
Moore: Mo+O+Re
isolacionismo: I+S+O+La+C+I+O+Ni+S+Mo | I+S+O+La+C+I+O+Ni+Sm+O | I+S+O+La+C+I+O+N+I+Sm+O | I+S+O+La+C+I+O+N+I+S+Mo
coliseu: C+O+Li+S+Eu | C+O+Li+Se+U | Co+Li+Se+U | Co+Li+S+Eu
Chirinola: C+H+Ir+I+N+O+La | C+H+Ir+I+No+La | C+H+Ir+In+O+La
chicanar: C+H+I+Ca+N+Ar
Chen: C+He+N
Beta: Be+Ta
Barny: B+Ar+N+Y | Ba+Rn+Y
Bakero: Ba+K+Er+O
american: Am+Er+I+Ca+N
tirânico: Ti+Ra+N+I+C+O | Ti+Ra+Ni+C+O | Ti+Ra+Ni+Co | Ti+Ra+N+I+Co
Sendero: Se+Nd+Er+O
pinheiral: P+In+He+Ir+Al | P+I+N+He+Ir+Al
Pinatubo: P+In+At+U+B+O | P+I+N+At+U+B+O
paginar: P+Ag+I+N+Ar | P+Ag+In+Ar
né: Ne
Kinnock: K+I+N+N+O+C+K | K+In+N+O+C+K | K+I+N+No+C+K | K+In+No+C+K
inestético: I+N+Es+Te+Ti+C+O | I+Ne+S+Te+Ti+Co | In+Es+Te+Ti+Co | I+Ne+S+Te+Ti+C+O | In+Es+Te+Ti+C+O
concubina: Co+N+C+U+B+I+Na | C+O+N+Cu+B+I+Na | C+O+N+C+U+Bi+Na | Co+N+C+U+Bi+Na | Co+N+Cu+B+I+Na | Co+N+Cu+Bi+Na | C+O+N+C+U+B+I+Na
bacoco: Ba+C+O+Co | Ba+Co+Co | Ba+Co+C+O | B+Ac+O+Co | Ba+C+O+C+O | B+Ac+O+C+O
ysso: Y+S+S+O
Vos: V+Os | V+O+S
pêsames: P+Es+Am+Es
polifônico: P+O+Li+F+O+Ni+C+O | P+O+Li+F+O+N+I+C+O | P+O+Li+F+O+N+I+Co | Po+Li+F+O+Ni+Co | Po+Li+F+O+Ni+C+O | Po+Li+F+O+N+I+C+O | Po+Li+F+O+N+I+Co
pack: Pa+C+K | P+Ac+K
Lafontaine: La+F+O+N+Ta+I+Ne
figa: F+I+Ga
crismar: Cr+I+Sm+Ar
céo: Ce+O
carteirista: C+Ar+Te+Ir+I+S+Ta
Camus: C+Am+U+S
campanário: C+Am+Pa+N+Ar+I+O
tiuer: Ti+U+Er
silício: S+I+Li+C+I+O | Si+Li+C+I+O
siamês: Si+Am+Es | S+I+Am+Es
Seis: Se+I+S
prolífico: Pr+O+Li+F+I+Co | Pr+O+Li+F+I+C+O
polinésio: P+O+Li+Ne+S+I+O | Po+Li+Ne+S+I+O | P+O+Li+Ne+Si+O | Po+Li+Ne+Si+O | P+O+Li+N+Es+I+O | Po+Li+N+Es+I+O
Onofre: O+No+F+Re | O+N+O+F+Re
life: Li+Fe
Céline: Ce+Li+Ne
cavalheiresco: Ca+V+Al+He+Ir+Es+C+O | Ca+V+Al+He+Ir+Es+Co | Ca+V+Al+He+I+Re+S+Co | Ca+V+Al+He+I+Re+S+C+O | Ca+V+Al+He+I+Re+Sc+O
broker: Br+O+K+Er
Bravo: B+Ra+V+O
Attali: At+Ta+Li
arranco: Ar+Ra+N+C+O | Ar+Ra+N+Co
alvarinho: Al+V+Ar+In+Ho | Al+V+Ar+In+H+O | Al+V+Ar+I+Nh+O | Al+V+Ar+I+N+Ho | Al+V+Ar+I+N+H+O
Alicante: Al+I+Ca+N+Te
Vita: V+I+Ta
superliga: S+U+P+Er+Li+Ga
Obras: O+Br+As | O+B+Ra+S
Nagano: Na+Ga+No | Na+Ga+N+O
Nablus: Na+B+Lu+S
moliceiro: Mo+Li+Ce+Ir+O
Lubitsch: Lu+Bi+Ts+C+H | Lu+B+I+Ts+C+H
genero: Ge+N+Er+O
Final: F+In+Al | F+I+N+Al
fetiche: Fe+Ti+C+He
Clareta: C+La+Re+Ta
arrebanhar: Ar+Re+Ba+Nh+Ar | Ar+Re+Ba+N+H+Ar
Walker: W+Al+K+Er
Tass: Ta+S+S
Swatch: S+W+At+C+H
recambiar: Re+C+Am+B+I+Ar | Re+C+Am+Bi+Ar
planar: P+La+N+Ar
paganismo: Pa+Ga+Ni+S+Mo | Pa+Ga+N+I+Sm+O | Pa+Ga+N+I+S+Mo | Pa+Ga+Ni+Sm+O
Ligeti: Li+Ge+Ti
his: H+I+S
funchal: F+U+N+C+H+Al
Cosec: C+O+Se+C | Co+Se+C
choupal: C+Ho+U+P+Al | C+H+O+U+P+Al
caviar: Ca+V+I+Ar
baby: Ba+B+Y
Amora: Am+O+Ra
White: W+H+I+Te
Uno: U+No | U+N+O
snob: Sn+O+B | S+No+B | S+N+O+B
reta: Re+Ta
rabiscar: Ra+B+I+Sc+Ar | Ra+Bi+Sc+Ar | Ra+B+I+S+C+Ar | Ra+Bi+S+C+Ar
pataco: Pa+Ta+C+O | Pa+Ta+Co | P+At+Ac+O
Papon: Pa+Po+N | Pa+P+O+N
monteirista: Mo+N+Te+Ir+I+S+Ta
Franklin: F+Ra+N+K+Li+N
fouce: F+O+U+Ce
Crisfal: Cr+I+S+F+Al
Casal: Ca+S+Al | C+As+Al
caír: Ca+Ir
cafre: Ca+F+Re
Baresi: Ba+Re+Si | B+Ar+Es+I | Ba+Re+S+I
arcaísmo: Ar+Ca+I+Sm+O | Ar+Ca+I+S+Mo
Aluno: Al+U+N+O | Al+U+No
Pernes: P+Er+N+Es | P+Er+Ne+S
Pawlak: Pa+W+La+K
ouuir: O+U+U+Ir
fiambre: F+I+Am+B+Re
cosmo: Co+Sm+O | C+O+S+Mo | Co+S+Mo | C+Os+Mo | C+O+Sm+O
Ciampi: C+I+Am+P+I
bonacheirão: B+O+N+Ac+He+I+Ra+O | B+O+Na+C+He+I+Ra+O
aragonês: Ar+Ag+O+Ne+S | Ar+Ag+O+N+Es
Amal: Am+Al
alibi: Al+I+B+I | Al+I+Bi
Titina: Ti+Ti+Na
Será: Se+Ra
Samora: S+Am+O+Ra
Pitico: P+I+Ti+Co | P+I+Ti+C+O
obelisco: O+Be+Li+S+Co | O+Be+Li+Sc+O | O+Be+Li+S+C+O
herbanário: H+Er+Ba+N+Ar+I+O
genebra: Ge+Ne+B+Ra
ganir: Ga+N+Ir
fotão: F+O+Ta+O
club: C+Lu+B | Cl+U+B
carolice: C+Ar+O+Li+Ce
canibalismo: Ca+N+I+Ba+Li+S+Mo | Ca+N+I+B+Al+I+Sm+O | Ca+Ni+B+Al+I+Sm+O | Ca+Ni+B+Al+I+S+Mo | Ca+Ni+Ba+Li+Sm+O | Ca+Ni+Ba+Li+S+Mo | Ca+N+I+B+Al+I+S+Mo
can: Ca+N
bis: B+I+S | Bi+S
bin: B+In | Bi+N | B+I+N
altear: Al+Te+Ar
Watson: W+At+S+O+N
Vários: V+Ar+I+O+S | V+Ar+I+Os
Urais: U+Ra+I+S
Sumolis: S+U+Mo+Li+S
so: S+O
snack: S+N+Ac+K | S+Na+C+K | Sn+Ac+K
Rubin: Ru+B+I+N | Ru+B+In | Ru+Bi+N
Pocinho: Po+C+I+N+Ho | P+O+C+I+N+H+O | Po+C+In+H+O | Po+C+I+N+H+O | P+O+C+In+H+O | Po+C+I+Nh+O | Po+C+In+Ho | P+O+C+In+Ho | P+O+C+I+Nh+O | P+O+C+I+N+Ho
Panis: Pa+N+I+S | Pa+Ni+S
Hélio: He+Li+O
Courage: C+O+U+Ra+Ge | Co+U+Ra+Ge
clarinetista: Cl+Ar+I+Ne+Ti+S+Ta
calibrar: Ca+Li+Br+Ar | C+Al+I+Br+Ar
Cacioli: C+Ac+I+O+Li | Ca+C+I+O+Li
berra: B+Er+Ra
balseiro: B+Al+Se+Ir+O
activismo: Ac+Ti+V+I+Sm+O | Ac+Ti+V+I+S+Mo
supersônico: S+U+P+Er+S+O+Ni+Co | S+U+P+Er+S+O+Ni+C+O | S+U+P+Er+S+O+N+I+Co | S+U+P+Er+S+O+N+I+C+O
René: Re+Ne
Parreira: P+Ar+Re+I+Ra
palacio: Pa+La+C+I+O | P+Al+Ac+I+O
money: Mo+Ne+Y
Lafões: La+F+O+Es
kiwi: K+I+W+I
hipopótamo: H+I+Po+Po+Ta+Mo | H+I+P+O+P+O+Ta+Mo | H+I+Po+P+O+Ta+Mo | H+I+P+O+Po+Ta+Mo
ham: H+Am
champô: C+H+Am+Po | C+H+Am+P+O
Catão: Ca+Ta+O
brita: Br+I+Ta
Raposo: Ra+Po+S+O | Ra+P+Os+O | Ra+P+O+S+O
preclaro: P+Re+Cl+Ar+O
pouso: Po+U+S+O | P+O+U+S+O
Oasis: O+As+I+S
espartano: Es+P+Ar+Ta+No | Es+P+Ar+Ta+N+O
cânhamo: Ca+N+H+Am+O | Ca+Nh+Am+O
certa: C+Er+Ta
Blanc: B+La+N+C
beirã: Be+I+Ra
Barnes: B+Ar+N+Es | B+Ar+Ne+S | Ba+Rn+Es
Aragon: Ar+Ag+O+N
tafetá: Ta+Fe+Ta
sincopar: S+In+Co+P+Ar | Si+N+Co+P+Ar | S+I+N+Co+P+Ar | S+In+C+O+P+Ar | S+I+N+C+O+P+Ar | Si+N+C+O+P+Ar
Scala: S+Ca+La
planura: P+La+N+U+Ra
official: O+F+F+I+C+I+Al
Mons: Mo+N+S
cólica: C+O+Li+Ca | Co+Li+Ca
Caterina: C+At+Er+I+Na
Capitão: Ca+P+I+Ta+O
Ben: Be+N
vita: V+I+Ta
vintage: V+In+Ta+Ge | V+I+N+Ta+Ge
verônica: V+Er+O+N+I+Ca | V+Er+O+Ni+Ca
samurai: S+Am+U+Ra+I
relancear: Re+La+N+Ce+Ar
plangente: P+La+N+Ge+N+Te
lacrimoso: La+Cr+I+Mo+S+O
ingente: In+Ge+N+Te | I+N+Ge+N+Te
hipotecário: H+I+Po+Te+C+Ar+I+O | H+I+P+O+Te+C+Ar+I+O
espargo: Es+Pa+Rg+O
crina: Cr+I+Na
Cooper: Co+O+P+Er | C+O+O+P+Er
coalhar: Co+Al+H+Ar | C+O+Al+H+Ar
Clip: C+Li+P | Cl+I+P
cacete: Ca+Ce+Te
Wisconsin: W+I+S+C+O+N+Si+N | W+I+Sc+O+N+Si+N | W+I+S+C+O+N+S+In | W+I+S+C+O+N+S+I+N | W+I+S+Co+N+S+In | W+I+S+Co+N+S+I+N | W+I+Sc+O+N+S+In | W+I+Sc+O+N+S+I+N | W+I+S+Co+N+Si+N
Stanic: S+Ta+Ni+C | S+Ta+N+I+C
racionar: Ra+C+I+O+N+Ar
preciosismo: P+Re+C+I+O+Si+Sm+O | P+Re+C+I+O+Si+S+Mo | P+Re+C+I+O+S+I+S+Mo | P+Re+C+I+O+S+I+Sm+O | P+Re+C+I+Os+I+S+Mo | P+Re+C+I+Os+I+Sm+O
genica: Ge+Ni+Ca | Ge+N+I+Ca
Flora: Fl+O+Ra
estéreo: Es+Te+Re+O
Cosmos: C+O+S+Mo+S | Co+Sm+O+S | C+O+Sm+Os | C+Os+Mo+S | Co+S+Mo+S | C+O+Sm+O+S | Co+Sm+Os
cãibra: Ca+I+B+Ra
capota: Ca+Po+Ta | Ca+P+O+Ta
cachalote: Ca+C+H+Al+O+Te | C+Ac+H+Al+O+Te
beat: Be+At
Bana: Ba+Na
vésperas: V+Es+P+Er+As
Viterbo: V+I+Te+Rb+O
Ver: V+Er
Talabani: Ta+La+Ba+N+I | Ta+La+Ba+Ni
Sutherland: S+U+Th+Er+La+Nd
States: S+Ta+Te+S
Soci: S+O+C+I
raspão: Ra+S+Pa+O
Ponte: Po+N+Te | P+O+N+Te
ponderoso: P+O+Nd+Er+O+S+O | Po+Nd+Er+O+S+O | P+O+Nd+Er+Os+O | Po+Nd+Er+Os+O
parêntese: Pa+Re+N+Te+Se
niilismo: N+I+I+Li+Sm+O | Ni+I+Li+S+Mo | N+I+I+Li+S+Mo | Ni+I+Li+Sm+O
Lucena: Lu+Ce+Na
Lubbers: Lu+B+B+Er+S
Kubrick: K+U+Br+I+C+K
Inhambane: In+H+Am+Ba+Ne | I+N+H+Am+Ba+Ne | I+Nh+Am+Ba+Ne
inepto: I+Ne+Pt+O
Hesse: He+S+Se | H+Es+Se
Georgina: Ge+O+Rg+I+Na
Frexes: F+Re+Xe+S
Ferencvaros: Fe+Re+N+C+V+Ar+O+S | Fe+Re+N+C+V+Ar+Os
facilitismo: F+Ac+I+Li+Ti+S+Mo | F+Ac+I+Li+Ti+Sm+O
cIC: C+I+C
Carreras: C+Ar+Re+Ra+S
Téchiné: Te+C+H+I+Ne
selvático: Se+Lv+At+I+C+O | Se+Lv+At+I+Co
scene: S+Ce+Ne
relicário: Re+Li+C+Ar+I+O
Picoas: P+I+Co+As | P+I+C+O+As
Limoges: Li+Mo+Ge+S
incluso: I+N+Cl+U+S+O | In+Cl+U+S+O | In+C+Lu+S+O | I+N+C+Lu+S+O
Husseini: H+U+S+Se+I+Ni | H+U+S+Se+I+N+I | H+U+S+Se+In+I
homónimo: H+O+Mo+Ni+Mo | H+O+Mo+N+I+Mo | Ho+Mo+N+I+Mo | Ho+Mo+Ni+Mo
corante: C+O+Ra+N+Te | Co+Ra+N+Te
Cabo: Ca+B+O
soslaio: S+Os+La+I+O | S+O+S+La+I+O
Shéu: S+He+U | S+H+Eu
propagandista: Pr+O+Pa+Ga+Nd+I+S+Ta
perseverar: P+Er+Se+V+Er+Ar
Oscar: Os+C+Ar | O+S+C+Ar | O+Sc+Ar
Negage: Ne+Ga+Ge
Mounir: Mo+U+N+Ir
lubrificante: Lu+Br+I+F+I+Ca+N+Te
álamo: Al+Am+O
Khatami: K+H+At+Am+I
imo: I+Mo
Flo: Fl+O
fólio: F+O+Li+O
cuco: C+U+C+O | Cu+Co | C+U+Co | Cu+C+O
cromo: Cr+O+Mo
cooptar: C+O+O+Pt+Ar | Co+O+Pt+Ar
Canelas: Ca+Ne+La+S
varina: V+Ar+I+Na
stá: S+Ta
Reynos: Re+Y+N+O+S | Re+Y+N+Os | Re+Y+No+S
purgar: Pu+Rg+Ar | P+U+Rg+Ar
Montesinho: Mo+N+Te+S+In+H+O | Mo+N+Te+Si+N+H+O | Mo+N+Te+S+I+N+H+O | Mo+N+Te+S+I+Nh+O | Mo+N+Te+S+In+Ho | Mo+N+Te+Si+Nh+O | Mo+N+Te+Si+N+Ho | Mo+N+Te+S+I+N+Ho
lasca: La+S+Ca
Kiki: K+I+K+I
crecer: C+Re+C+Er
che: C+He
Can: Ca+N
Brá: B+Ra
acusativo: Ac+U+S+At+I+V+O
viseira: V+I+Se+I+Ra
universalismo: U+Ni+V+Er+S+Al+I+Sm+O | U+Ni+V+Er+S+Al+I+S+Mo | U+N+I+V+Er+S+Al+I+Sm+O | U+N+I+V+Er+S+Al+I+S+Mo
supa: S+U+Pa
rácico: Ra+C+I+C+O | Ra+C+I+Co
pPP: P+P+P
pi: P+I
perfeccionista: P+Er+Fe+C+C+I+O+N+I+S+Ta | P+Er+Fe+C+C+I+O+Ni+S+Ta
morabitino: Mo+Ra+Bi+Ti+N+O | Mo+Ra+B+I+Ti+No | Mo+Ra+B+I+Ti+N+O | Mo+Ra+Bi+Ti+No
Lulu: Lu+Lu
Ipamb: I+P+Am+B
Hook: Ho+O+K | H+O+O+K
Falla: F+Al+La
Cousteau: Co+U+S+Te+Au | C+O+U+S+Te+Au
Cage: Ca+Ge
braseiro: B+Ra+Se+Ir+O
body: B+O+Dy
Bauhaus: B+Au+H+Au+S | Ba+U+H+Au+S
virote: V+Ir+O+Te
sinopse: S+I+No+P+Se | Si+N+O+P+Se | Si+No+P+Se | S+In+O+P+Se | S+I+N+O+P+Se
proxeneta: Pr+O+Xe+Ne+Ta
presencial: P+Re+Se+N+C+I+Al
Políbio: Po+Li+B+I+O | P+O+Li+B+I+O | P+O+Li+Bi+O | Po+Li+Bi+O
Pantani: Pa+N+Ta+Ni | Pa+N+Ta+N+I
Orestes: O+Re+S+Te+S
ínvio: In+V+I+O | I+N+V+I+O
nobi: N+O+Bi | No+B+I | N+O+B+I | No+Bi
ínicio: I+Ni+C+I+O | I+N+I+C+I+O | In+I+C+I+O
monossílabo: Mo+N+Os+S+I+La+B+O | Mo+N+O+S+Si+La+B+O | Mo+No+S+S+I+La+B+O | Mo+No+S+Si+La+B+O | Mo+N+Os+Si+La+B+O | Mo+N+O+S+S+I+La+B+O
liamba: Li+Am+Ba
Land: La+Nd
frisson: Fr+I+S+S+O+N
Falcon: F+Al+C+O+N | F+Al+Co+N
espírita: Es+P+Ir+I+Ta
esófago: Es+O+F+Ag+O
causal: C+Au+S+Al | Ca+U+S+Al
carocho: C+Ar+O+C+Ho | C+Ar+O+C+H+O
bufar: B+U+F+Ar
Acarte: Ac+Ar+Te
vobi: V+O+Bi | V+O+B+I
vespa: V+Es+Pa
Tirésias: Ti+Re+Si+As | Ti+Re+S+I+As
pasmoso: Pa+Sm+O+S+O | Pa+Sm+Os+O | P+As+Mo+S+O | Pa+S+Mo+S+O
Pascal: Pa+Sc+Al | P+As+C+Al | Pa+S+C+Al
fusco: F+U+S+Co | F+U+S+C+O | F+U+Sc+O
farra: F+Ar+Ra
clicar: Cl+I+C+Ar | C+Li+C+Ar
chicana: C+H+I+Ca+Na
bluesy: B+Lu+Es+Y
arsénico: Ar+Se+Ni+C+O | Ar+Se+N+I+C+O | Ar+Se+N+I+Co | Ar+Se+Ni+Co
argelina: Ar+Ge+Li+Na
tever: Te+V+Er
tanga: Ta+N+Ga
salmonela: S+Al+Mo+Ne+La
Paco: P+Ac+O | Pa+Co | Pa+C+O
Namibe: N+Am+I+Be
Kirsten: K+Ir+S+Te+N
ingenho: I+N+Ge+Nh+O | I+N+Ge+N+H+O | I+N+Ge+N+Ho | In+Ge+N+H+O | In+Ge+N+Ho | In+Ge+Nh+O
inebriar: I+Ne+Br+I+Ar
gen: Ge+N
Febo: Fe+B+O
Chamusca: C+H+Am+U+S+Ca
cevar: Ce+V+Ar
ceo: Ce+O
Cendrev: Ce+Nd+Re+V
cantante: Ca+N+Ta+N+Te
Brando: B+Ra+Nd+O
Bond: B+O+Nd
Bergen: B+Er+Ge+N
balar: B+Al+Ar
alisar: Al+I+S+Ar
alheo: Al+He+O
servilismo: S+Er+V+I+Li+Sm+O | S+Er+V+I+Li+S+Mo
reynar: Re+Y+N+Ar
Pau: P+Au | Pa+U
Noga: No+Ga | N+O+Ga
Montana: Mo+N+Ta+Na
Indy: I+Nd+Y | In+Dy | I+N+Dy
halo: H+Al+O
esposar: Es+Po+S+Ar | Es+P+Os+Ar | Es+P+O+S+Ar
esbofetear: Es+B+O+Fe+Te+Ar
busílis: B+U+S+I+Li+S | B+U+Si+Li+S
batelão: Ba+Te+La+O
amotinar: Am+O+Ti+N+Ar
vinheta: V+In+He+Ta | V+I+N+He+Ta
pressagiar: Pr+Es+S+Ag+I+Ar | P+Re+S+S+Ag+I+Ar
Poceirão: P+O+Ce+I+Ra+O | Po+Ce+I+Ra+O
Nina: Ni+Na | N+I+Na
lanchar: La+N+C+H+Ar
irra: Ir+Ra
inativar: I+N+At+I+V+Ar | In+At+I+V+Ar | I+Na+Ti+V+Ar
inapto: I+Na+Pt+O
ih: I+H
book: B+O+O+K
arreio: Ar+Re+I+O
Algeciras: Al+Ge+C+Ir+As | Al+Ge+C+I+Ra+S
acicatar: Ac+I+C+At+Ar
Voyager: V+O+Y+Ag+Er
salso: S+Al+S+O
rasteirar: Ra+S+Te+Ir+Ar
palhota: P+Al+H+O+Ta | P+Al+Ho+Ta
oficinal: O+F+I+C+I+N+Al | O+F+I+C+In+Al
livreira: Li+V+Re+I+Ra
internauta: In+Te+Rn+Au+Ta | I+N+Te+Rn+Au+Ta
Fusco: F+U+S+Co | F+U+S+C+O | F+U+Sc+O
fecal: Fe+C+Al
Crespo: Cr+Es+P+O | C+Re+S+Po | C+Re+S+P+O | Cr+Es+Po
Casiraghi: Ca+S+Ir+Ag+H+I | C+As+Ir+Ag+H+I
cache: C+Ac+He | Ca+C+He
varino: V+Ar+I+No | V+Ar+In+O | V+Ar+I+N+O
tifosi: Ti+F+O+S+I | Ti+F+O+Si | Ti+F+Os+I
Temos: Te+Mo+S
sound: S+O+U+Nd
salpicão: S+Al+P+I+Ca+O
recitativo: Re+C+I+Ta+Ti+V+O
popularucho: Po+Pu+La+Ru+C+Ho | Po+P+U+La+Ru+C+H+O | Po+Pu+La+Ru+C+H+O | P+O+P+U+La+Ru+C+H+O | Po+P+U+La+Ru+C+Ho | P+O+P+U+La+Ru+C+Ho | P+O+Pu+La+Ru+C+H+O
Popov: Po+P+O+V | P+O+P+O+V | P+O+Po+V | Po+Po+V
plástica: P+La+S+Ti+Ca
púbico: P+U+B+I+C+O | Pu+Bi+C+O | Pu+Bi+Co | Pu+B+I+Co | Pu+B+I+C+O | P+U+Bi+C+O | P+U+B+I+Co
paio: Pa+I+O
niilista: Ni+I+Li+S+Ta | N+I+I+Li+S+Ta
Nick: Ni+C+K | N+I+C+K
Nafta: Na+F+Ta
geofísico: Ge+O+F+I+Si+Co | Ge+O+F+I+S+I+Co | Ge+O+F+I+Si+C+O | Ge+O+F+I+S+I+C+O
falsário: F+Al+S+Ar+I+O
Eureko: Eu+Re+K+O
Cossiga: C+Os+Si+Ga | C+Os+S+I+Ga | Co+S+S+I+Ga | C+O+S+S+I+Ga | Co+S+Si+Ga | C+O+S+Si+Ga
castanheira: C+As+Ta+N+He+I+Ra | Ca+S+Ta+N+He+I+Ra
bos: B+O+S | B+Os
Baroni: B+Ar+O+N+I | B+Ar+O+Ni
Alfonso: Al+F+O+N+S+O
vibrato: V+I+Br+At+O
vaginal: V+Ag+In+Al | V+Ag+I+N+Al
Spartak: S+P+Ar+Ta+K
snooker: S+No+O+K+Er | S+N+O+O+K+Er | Sn+O+O+K+Er
Simonyi: S+I+Mo+N+Y+I | Si+Mo+N+Y+I
Remo: Re+Mo
Parnaso: P+Ar+Na+S+O | P+Ar+N+As+O | Pa+Rn+As+O
papoila: Pa+P+O+I+La | Pa+Po+I+La
papista: Pa+P+I+S+Ta
Pag: P+Ag
Once: O+N+Ce
nauio: Na+U+I+O | N+Au+I+O
linchar: Li+N+C+H+Ar
Lib: Li+B
Kouba: K+O+U+Ba
ipso: I+P+S+O
Geota: Ge+O+Ta
fisioterapeuta: F+I+S+I+O+Te+Ra+P+Eu+Ta | F+I+Si+O+Te+Ra+P+Eu+Ta
Citibank: C+I+Ti+Ba+N+K
cindir: C+I+Nd+Ir
boat: B+O+At
Barreiros: B+Ar+Re+Ir+O+S | B+Ar+Re+Ir+Os
amuo: Am+U+O
vesúvio: V+Es+U+V+I+O
surfar: S+U+Rf+Ar
Prosinecki: Pr+O+S+I+Ne+C+K+I | Pr+O+Si+Ne+C+K+I | Pr+Os+I+Ne+C+K+I
Pop: P+O+P | Po+P
Lu: Lu
huno: H+U+No | H+U+N+O
Ganges: Ga+N+Ge+S
festão: F+Es+Ta+O | Fe+S+Ta+O
Fesete: Fe+Se+Te
carpa: C+Ar+Pa
babuíno: Ba+B+U+In+O | Ba+B+U+I+No | Ba+B+U+I+N+O
arrufo: Ar+Ru+F+O
upa: U+Pa
Tebas: Te+B+As | Te+Ba+S
prouer: Pr+O+U+Er
livrete: Li+V+Re+Te
Fitei: F+I+Te+I
eros: Er+Os | Er+O+S
Ceira: Ce+I+Ra
camp: C+Am+P
Brisbane: Br+I+S+Ba+Ne
biosfera: Bi+Os+Fe+Ra | Bi+O+S+Fe+Ra | B+I+Os+Fe+Ra | B+I+O+S+Fe+Ra
bacon: Ba+C+O+N | Ba+Co+N | B+Ac+O+N
arrais: Ar+Ra+I+S
alvar: Al+V+Ar
Alfena: Al+Fe+Na
unifamiliar: U+Ni+F+Am+I+Li+Ar | U+N+I+F+Am+I+Li+Ar
subcontinente: S+U+B+Co+N+Ti+Ne+N+Te | S+U+B+C+O+N+Ti+Ne+N+Te
Sonatrach: S+O+N+At+Ra+C+H
psicótico: P+S+I+C+O+Ti+C+O | P+Si+C+O+Ti+C+O | P+Si+Co+Ti+C+O | P+Si+Co+Ti+Co | P+S+I+C+O+Ti+Co | P+Si+C+O+Ti+Co | P+S+I+Co+Ti+C+O | P+S+I+Co+Ti+Co
over: O+V+Er
omner: O+Mn+Er
Observer: O+B+S+Er+V+Er
Nabokov: Na+B+O+K+O+V
eucarístico: Eu+C+Ar+I+S+Ti+Co | Eu+C+Ar+I+S+Ti+C+O
Cires: C+I+Re+S | C+Ir+Es
catita: Ca+Ti+Ta | C+At+I+Ta
caprichar: Ca+Pr+I+C+H+Ar
Aspa: As+Pa
what: W+H+At
remoer: Re+Mo+Er
Racine: Ra+C+I+Ne
profuso: Pr+O+F+U+S+O
pousio: P+O+U+S+I+O | P+O+U+Si+O | Po+U+Si+O | Po+U+S+I+O
Pouco: Po+U+Co | Po+U+C+O | P+O+U+Co | P+O+U+C+O
palheta: P+Al+He+Ta
Palace: Pa+La+Ce
pacifismo: Pa+C+I+F+I+S+Mo | P+Ac+I+F+I+Sm+O | P+Ac+I+F+I+S+Mo | Pa+C+I+F+I+Sm+O
Moon: Mo+O+N
Kirch: K+Ir+C+H
cilício: C+I+Li+C+I+O
cerimonioso: C+Er+I+Mo+Ni+O+S+O | C+Er+I+Mo+Ni+Os+O | C+Er+I+Mo+N+I+O+S+O | C+Er+I+Mo+N+I+Os+O
cacifo: C+Ac+I+F+O | Ca+C+I+F+O
Bernès: B+Er+Ne+S | B+Er+N+Es | Be+Rn+Es
varíola: V+Ar+I+O+La
supra: S+U+P+Ra
ski: S+K+I
reprise: Re+Pr+I+Se
Rentipar: Re+N+Ti+P+Ar
plasmar: P+La+Sm+Ar
Lacan: La+Ca+N
clarear: C+La+Re+Ar
Cartagena: C+Ar+Ta+Ge+Na
bopper: B+O+P+P+Er
Boksic: B+O+K+S+I+C | B+O+K+Si+C
bocca: B+O+C+Ca
Atlantic: At+La+N+Ti+C
rés: Re+S
Punta: Pu+N+Ta | P+U+N+Ta
Pioline: P+I+O+Li+Ne
Novo: N+O+V+O | No+V+O
hipnose: H+I+P+No+Se | H+I+P+N+O+Se
fagote: F+Ag+O+Te
Estamos: Es+Ta+Mo+S
esmo: Es+Mo
clic: Cl+I+C | C+Li+C
chofre: C+Ho+F+Re | C+H+O+F+Re
chiste: C+H+I+S+Te
Arcarons: Ar+C+Ar+O+N+S
alba: Al+Ba
sônico: S+O+Ni+Co | S+O+Ni+C+O | S+O+N+I+Co | S+O+N+I+C+O
Severino: Se+V+Er+I+N+O | Se+V+Er+In+O | Se+V+Er+I+No
recebeo: Re+Ce+Be+O
Olano: O+La+No | O+La+N+O
md: Md
lacrar: La+Cr+Ar
fermosas: F+Er+Mo+S+As
estivar: Es+Ti+V+Ar
Cartas: C+Ar+Ta+S
canoísta: Ca+N+O+I+S+Ta | Ca+No+I+S+Ta
vitícola: V+I+Ti+Co+La | V+I+Ti+C+O+La
Soho: S+O+Ho | S+O+H+O
sô: S+O
placenta: P+La+Ce+N+Ta
púcaro: P+U+C+Ar+O | Pu+C+Ar+O
Paraná: Pa+Ra+Na
pô: P+O | Po
Office: O+F+F+I+Ce
Nasser: N+As+S+Er | Na+S+S+Er
Kocinski: K+O+C+In+S+K+I | K+O+C+I+N+S+K+I
Hola: H+O+La | Ho+La
fogacho: F+O+Ga+C+Ho | F+Og+Ac+Ho | F+O+Ga+C+H+O | F+Og+Ac+H+O
Ferrara: F+Er+Ra+Ra
eucaliptal: Eu+C+Al+I+Pt+Al | Eu+Ca+Li+Pt+Al
cuba: Cu+Ba | C+U+Ba
convalescente: Co+N+V+Al+Es+Ce+N+Te | C+O+N+V+Al+Es+Ce+N+Te
colaborante: Co+La+B+O+Ra+N+Te | C+O+La+B+O+Ra+N+Te
Caso: C+As+O | Ca+S+O
Cameron: C+Am+Er+O+N
Alvarinho: Al+V+Ar+In+Ho | Al+V+Ar+In+H+O | Al+V+Ar+I+Nh+O | Al+V+Ar+I+N+Ho | Al+V+Ar+I+N+H+O
alcobacense: Al+C+O+Ba+Ce+N+Se | Al+Co+Ba+Ce+N+Se
achincalhar: Ac+H+In+C+Al+H+Ar | Ac+H+I+N+C+Al+H+Ar
Warp: W+Ar+P
tétano: Te+Ta+No | Te+Ta+N+O
substanciar: S+U+B+S+Ta+N+C+I+Ar
Stendhal: S+Te+Nd+H+Al
Sobralinho: S+O+Br+Al+I+Nh+O | S+O+B+Ra+Li+N+Ho | S+O+Br+Al+In+H+O | S+O+B+Ra+Li+N+H+O | S+O+Br+Al+I+N+H+O | S+O+Br+Al+In+Ho | S+O+B+Ra+Li+Nh+O | S+O+Br+Al+I+N+Ho
pC: P+C
Moutinho: Mo+U+Ti+N+H+O | Mo+U+Ti+Nh+O | Mo+U+Ti+N+Ho
Island: I+S+La+Nd
Freire: F+Re+I+Re
ferreira: F+Er+Re+I+Ra
Ericsson: Er+I+C+S+S+O+N | Er+I+Cs+S+O+N
Comores: C+O+Mo+Re+S | Co+Mo+Re+S
cibernauta: C+I+B+Er+N+Au+Ta | C+I+Be+Rn+Au+Ta | C+I+B+Er+Na+U+Ta
chambre: C+H+Am+B+Re
Cao: Ca+O
bragantino: B+Ra+Ga+N+Ti+N+O | B+Ra+Ga+N+Ti+No
babar: Ba+B+Ar
agiota: Ag+I+O+Ta
Woody: W+O+O+Dy
Vuvu: V+U+V+U
Vivi: V+I+V+I
Stein: S+Te+I+N | S+Te+In
soccer: S+O+C+C+Er
Pirinéus: P+Ir+I+N+Eu+S | P+Ir+In+Eu+S | P+Ir+I+Ne+U+S
pira: P+I+Ra
Operário: O+P+Er+Ar+I+O
nunciatura: N+U+N+C+I+At+U+Ra
noute: N+O+U+Te | No+U+Te
Notícias: No+Ti+C+I+As | N+O+Ti+C+I+As
nicar: N+I+C+Ar | Ni+C+Ar
Mt: Mt
Laurentino: La+U+Re+N+Ti+N+O | La+U+Re+N+Ti+No
Iscal: I+S+C+Al | I+Sc+Al
Hobbes: H+O+B+B+Es | Ho+B+Be+S | H+O+B+Be+S | Ho+B+B+Es
Fraga: F+Ra+Ga
espiritismo: Es+P+Ir+I+Ti+S+Mo | Es+P+Ir+I+Ti+Sm+O
corânico: Co+Ra+N+I+Co | C+O+Ra+N+I+Co | Co+Ra+N+I+C+O | C+O+Ra+Ni+C+O | Co+Ra+Ni+C+O | Co+Ra+Ni+Co | C+O+Ra+N+I+C+O
cofiar: Co+F+I+Ar | C+O+F+I+Ar
carreta: C+Ar+Re+Ta
capuchinho: Ca+P+U+C+H+I+N+H+O | Ca+Pu+C+H+In+Ho | Ca+P+U+C+H+In+H+O | Ca+Pu+C+H+I+N+H+O | Ca+P+U+C+H+I+Nh+O | Ca+P+U+C+H+In+Ho | Ca+Pu+C+H+In+H+O | Ca+Pu+C+H+I+Nh+O | Ca+P+U+C+H+I+N+Ho | Ca+Pu+C+H+I+N+Ho
capar: Ca+P+Ar
Canário: Ca+N+Ar+I+O
bolina: B+O+Li+Na
Boca: B+O+Ca
Steiner: S+Te+I+N+Er | S+Te+In+Er
season: Se+As+O+N
putativo: P+U+Ta+Ti+V+O | Pu+Ta+Ti+V+O
procriar: Pr+O+Cr+I+Ar
pirite: P+Ir+I+Te
Nono: N+O+N+O | No+No | No+N+O | N+O+No
nã: Na
gamo: Ga+Mo
estela: Es+Te+La
chorão: C+Ho+Ra+O | C+H+O+Ra+O
Cercal: C+Er+C+Al
beca: Be+Ca
batista: B+At+I+S+Ta | Ba+Ti+S+Ta
assoberbar: As+S+O+B+Er+B+Ar | As+S+O+Be+Rb+Ar
asco: As+C+O | As+Co
Alfeite: Al+Fe+I+Te
Albino: Al+Bi+N+O | Al+Bi+No | Al+B+I+No | Al+B+I+N+O | Al+B+In+O
Superbikes: S+U+P+Er+Bi+K+Es | S+U+P+Er+B+I+K+Es
ártico: Ar+Ti+Co | Ar+Ti+C+O
profundíssimo: Pr+O+F+U+Nd+I+S+S+I+Mo | Pr+O+F+U+Nd+I+S+Si+Mo
poial: Po+I+Al | P+O+I+Al
hooliganismo: Ho+O+Li+Ga+Ni+Sm+O | H+O+O+Li+Ga+N+I+S+Mo | Ho+O+Li+Ga+N+I+Sm+O | H+O+O+Li+Ga+Ni+S+Mo | Ho+O+Li+Ga+Ni+S+Mo | H+O+O+Li+Ga+N+I+Sm+O | Ho+O+Li+Ga+N+I+S+Mo
geoestacionário: Ge+O+Es+Ta+C+I+O+N+Ar+I+O
genitivo: Ge+N+I+Ti+V+O | Ge+Ni+Ti+V+O
garboso: Ga+Rb+Os+O | Ga+Rb+O+S+O
Conakry: Co+Na+Kr+Y | C+O+Na+Kr+Y
Club: C+Lu+B | Cl+U+B
chifre: C+H+I+F+Re
batismo: Ba+Ti+Sm+O | B+At+I+Sm+O | Ba+Ti+S+Mo | B+At+I+S+Mo
teta: Te+Ta
tenístico: Te+N+I+S+Ti+C+O | Te+N+I+S+Ti+Co | Te+Ni+S+Ti+C+O | Te+Ni+S+Ti+Co
tabla: Ta+B+La
sátiro: S+At+Ir+O
Sternberg: S+Te+Rn+Be+Rg
Stagecoach: S+Ta+Ge+C+O+Ac+H | S+Ta+Ge+Co+Ac+H
soba: S+O+Ba
Sharp: S+H+Ar+P
recamar: Re+C+Am+Ar
Pioneer: P+I+O+Ne+Er
peralta: P+Er+Al+Ta
irir: Ir+Ir
hambúrguer: H+Am+B+U+Rg+U+Er
ferrete: F+Er+Re+Te
escalabitano: Es+Ca+La+B+I+Ta+No | Es+Ca+La+Bi+Ta+N+O | Es+Ca+La+B+I+Ta+N+O | Es+Ca+La+Bi+Ta+No
copta: Co+P+Ta | C+O+P+Ta
Conner: C+O+N+N+Er | Co+N+N+Er
colaboracionismo: Co+La+B+O+Ra+C+I+O+N+I+Sm+O | Co+La+B+O+Ra+C+I+O+Ni+S+Mo | C+O+La+B+O+Ra+C+I+O+N+I+Sm+O | Co+La+B+O+Ra+C+I+O+Ni+Sm+O | C+O+La+B+O+Ra+C+I+O+Ni+S+Mo | C+O+La+B+O+Ra+C+I+O+N+I+S+Mo | Co+La+B+O+Ra+C+I+O+N+I+S+Mo
cabrão: Ca+B+Ra+O
alpaca: Al+Pa+Ca
Walsh: W+Al+S+H
Uns: U+N+S
taipal: Ta+I+P+Al
Syberberg: S+Y+B+Er+Be+Rg | S+Yb+Er+Be+Rg
seruir: Se+Ru+Ir | S+Er+U+Ir
sambar: S+Am+B+Ar
raynho: Ra+Y+Nh+O | Ra+Y+N+H+O | Ra+Y+N+Ho
prisioneira: Pr+I+Si+O+Ne+I+Ra | Pr+I+S+I+O+Ne+I+Ra
percepcionar: P+Er+Ce+P+C+I+O+N+Ar
org: O+Rg
McKinsey: Mc+K+I+N+Se+Y | Mc+K+In+Se+Y
litigante: Li+Ti+Ga+N+Te
huu: H+U+U
Gastão: Ga+S+Ta+O
cítara: C+I+Ta+Ra
cócora: Co+Co+Ra | Co+C+O+Ra | C+O+Co+Ra | C+O+C+O+Ra
Casino: C+As+I+N+O | Ca+S+I+No | Ca+S+I+N+O | Ca+S+In+O | C+As+In+O | Ca+Si+N+O | Ca+Si+No
Caritas: C+Ar+I+Ta+S
bacante: Ba+Ca+N+Te
vibrafone: V+I+B+Ra+F+O+Ne
sibila: S+I+B+I+La | Si+Bi+La | Si+B+I+La | S+I+Bi+La
Pais: Pa+I+S
osseta: Os+Se+Ta | O+S+Se+Ta
Olivier: O+Li+V+I+Er
náo: Na+O
narcísico: N+Ar+C+I+S+I+C+O | N+Ar+C+I+Si+C+O | N+Ar+C+I+S+I+Co | N+Ar+C+I+Si+Co
hacker: H+Ac+K+Er
Eufrates: Eu+Fr+At+Es | Eu+F+Ra+Te+S
esteiro: Es+Te+Ir+O
escolástico: Es+Co+La+S+Ti+Co | Es+C+O+La+S+Ti+C+O | Es+C+O+La+S+Ti+Co | Es+Co+La+S+Ti+C+O
cubismo: C+U+B+I+S+Mo | Cu+Bi+Sm+O | C+U+Bi+S+Mo | Cu+B+I+Sm+O | C+U+B+I+Sm+O | Cu+B+I+S+Mo | Cu+Bi+S+Mo
cônico: Co+N+I+C+O | C+O+Ni+C+O | Co+Ni+Co | C+O+N+I+C+O | Co+N+I+Co | C+O+N+I+Co | Co+Ni+C+O
ciciar: C+I+C+I+Ar
chicotear: C+H+I+C+O+Te+Ar | C+H+I+Co+Te+Ar
carola: C+Ar+O+La
biogás: Bi+O+Ga+S | Bi+Og+As | B+I+Og+As | B+I+O+Ga+S
Bacon: Ba+C+O+N | Ba+Co+N | B+Ac+O+N
Yassin: Y+As+S+I+N | Y+As+S+In | Y+As+Si+N
vivificar: V+I+V+I+F+I+C+Ar
Verlaine: V+Er+La+I+Ne
successo: S+U+C+C+Es+S+O | S+U+C+Ce+S+S+O
Srinagar: Sr+I+N+Ag+Ar | Sr+In+Ag+Ar
spero: S+P+Er+O
Sobral: S+O+Br+Al
republicar: Re+P+U+B+Li+C+Ar | Re+Pu+B+Li+C+Ar
prevaricar: P+Re+V+Ar+I+C+Ar
pontifical: Po+N+Ti+F+I+C+Al | P+O+N+Ti+F+I+C+Al
pero: P+Er+O
patusco: P+At+U+S+C+O | P+At+U+Sc+O | P+At+U+S+Co
Parsifal: P+Ar+Si+F+Al | P+Ar+S+I+F+Al
Nico: Ni+C+O | N+I+C+O | N+I+Co | Ni+Co
Hepburn: He+P+B+U+Rn | He+Pb+U+Rn
fisga: F+I+S+Ga
ferrão: F+Er+Ra+O
Felício: Fe+Li+C+I+O
Faustino: F+Au+S+Ti+No | F+Au+S+Ti+N+O
clavina: C+La+V+I+Na
chacal: C+H+Ac+Al
castelão: Ca+S+Te+La+O | C+As+Te+La+O
Bentes: Be+N+Te+S
banheiro: Ba+N+He+Ir+O
arreganhar: Ar+Re+Ga+N+H+Ar | Ar+Re+Ga+Nh+Ar
Ambelis: Am+Be+Li+S
alvíssaras: Al+V+I+S+S+Ar+As
uni: U+Ni | U+N+I
tabanca: Ta+Ba+N+Ca
Soserfin: S+Os+Er+F+In | S+O+S+Er+F+In | S+O+Se+Rf+In | S+Os+Er+F+I+N | S+O+S+Er+F+I+N
sólio: S+O+Li+O
sensitivo: Se+N+S+I+Ti+V+O | Se+N+Si+Ti+V+O
playboy: P+La+Y+B+O+Y | P+La+Yb+O+Y
Paulina: P+Au+Li+Na | Pa+U+Li+Na
nauta: N+Au+Ta | Na+U+Ta
Mc: Mc
Kirov: K+Ir+O+V
Friburgo: Fr+I+B+U+Rg+O
felá: Fe+La
fatigante: F+At+I+Ga+N+Te
Crónicas: Cr+O+N+I+C+As | Cr+O+Ni+Ca+S | Cr+O+N+I+Ca+S | Cr+O+Ni+C+As
couce: C+O+U+Ce | Co+U+Ce
Camdessus: Ca+Md+Es+S+U+S
Bruckner: Br+U+C+K+N+Er | B+Ru+C+K+N+Er
broca: Br+O+Ca
breu: B+Re+U | Br+Eu
Beck: Be+C+K
Basaúla: Ba+S+Au+La | B+As+Au+La
valo: V+Al+O
Unifer: U+N+I+F+Er | U+Ni+F+Er
Tibães: Ti+Ba+Es
Tasso: Ta+S+S+O
Serrano: S+Er+Ra+No | S+Er+Ra+N+O
Rusedski: Ru+Se+Ds+K+I
regabofe: Re+Ga+B+O+Fe
posicional: P+Os+I+C+I+O+N+Al | P+O+Si+C+I+O+N+Al | Po+S+I+C+I+O+N+Al | Po+Si+C+I+O+N+Al | P+O+S+I+C+I+O+N+Al
Platini: P+La+Ti+N+I | P+La+Ti+Ni
plantio: P+La+N+Ti+O
Par: P+Ar
Palop: P+Al+O+P
nô: No | N+O
mt: Mt
lítio: Li+Ti+O
limo: Li+Mo
itálico: I+Ta+Li+Co | I+Ta+Li+C+O
Génesis: Ge+Ne+Si+S | Ge+N+Es+I+S | Ge+Ne+S+I+S
Facar: F+Ac+Ar
Euora: Eu+O+Ra
esc: Es+C
cravista: C+Ra+V+I+S+Ta
Coluna: C+O+Lu+Na | Co+Lu+Na
chat: C+H+At
centenares: Ce+N+Te+N+Ar+Es | Ce+N+Te+Na+Re+S
bananeira: Ba+Na+Ne+I+Ra
amoníaco: Am+O+Ni+Ac+O | Am+O+N+I+Ac+O
Albertino: Al+B+Er+Ti+N+O | Al+B+Er+Ti+No
Acontece: Ac+O+N+Te+Ce
vasco: V+As+Co | V+As+C+O
Tati: Ta+Ti
rectilíneo: Re+C+Ti+Li+Ne+O
Rebecca: Re+Be+C+Ca
Puna: P+U+Na | Pu+Na
Populares: P+O+Pu+La+Re+S | P+O+P+U+La+Re+S | Po+P+U+La+Re+S | Po+Pu+La+Re+S
np: N+P | Np
limousine: Li+Mo+U+Si+Ne | Li+Mo+U+S+I+Ne
fichar: F+I+C+H+Ar
escabeche: Es+Ca+Be+C+He
cripta: Cr+I+P+Ta
copla: Co+P+La | C+O+P+La
Chi: C+H+I
Brabham: B+Ra+B+H+Am | B+Ra+Bh+Am
arsenalista: Ar+Se+N+Al+I+S+Ta | Ar+Se+Na+Li+S+Ta
viuo: V+I+U+O
Viola: V+I+O+La
Vieri: V+I+Er+I
sincrético: Si+N+C+Re+Ti+C+O | S+In+C+Re+Ti+C+O | S+In+C+Re+Ti+Co | Si+N+C+Re+Ti+Co | S+I+N+C+Re+Ti+Co | S+I+N+C+Re+Ti+C+O
prestimoso: Pr+Es+Ti+Mo+S+O | P+Re+S+Ti+Mo+S+O
Pindo: P+I+Nd+O
larguíssimo: La+Rg+U+I+S+S+I+Mo | La+Rg+U+I+S+Si+Mo
lacerar: La+C+Er+Ar
Forbs: F+O+Rb+S
fauce: F+Au+Ce
cascalho: Ca+S+C+Al+Ho | C+As+C+Al+Ho | Ca+Sc+Al+H+O | Ca+Sc+Al+Ho | C+As+C+Al+H+O | Ca+S+C+Al+H+O
calheta: C+Al+He+Ta
bobina: B+O+Bi+Na | B+O+B+I+Na
ampola: Am+P+O+La | Am+Po+La
Srs: Sr+S
spaspa: S+Pa+S+Pa | S+P+As+Pa
shows: S+H+O+W+S | S+Ho+W+S
profiláctico: Pr+O+F+I+La+C+Ti+C+O | Pr+O+F+I+La+C+Ti+Co
probo: Pr+O+B+O
pavio: Pa+V+I+O
Pargeste: P+Ar+Ge+S+Te | Pa+Rg+Es+Te
paninho: Pa+N+In+H+O | Pa+N+I+N+H+O | Pa+Ni+Nh+O | Pa+N+I+Nh+O | Pa+N+I+N+Ho | Pa+N+In+Ho | Pa+Ni+N+H+O | Pa+Ni+N+Ho
libris: Li+Br+I+S
là: La
he: He
fauno: F+Au+No | F+Au+N+O
espairecer: Es+Pa+I+Re+C+Er
esconso: Es+Co+N+S+O | Es+C+O+N+S+O
cherne: C+H+Er+Ne
bragar: Br+Ag+Ar
bisonho: B+I+S+O+Nh+O | B+I+S+O+N+H+O | Bi+S+O+Nh+O | Bi+S+O+N+Ho | Bi+S+O+N+H+O | B+I+S+O+N+Ho
atlantista: At+La+N+Ti+S+Ta
was: W+As
valiosíssimo: V+Al+I+O+S+I+S+S+I+Mo | V+Al+I+O+S+I+S+Si+Mo | V+Al+I+Os+I+S+S+I+Mo | V+Al+I+O+Si+S+S+I+Mo | V+Al+I+O+Si+S+Si+Mo | V+Al+I+Os+I+S+Si+Mo
unívoco: U+N+I+V+O+C+O | U+Ni+V+O+C+O | U+Ni+V+O+Co | U+N+I+V+O+Co
Shengen: S+He+N+Ge+N
sentencioso: Se+N+Te+N+C+I+O+S+O | Se+N+Te+N+C+I+Os+O
scena: S+Ce+Na
saltitante: S+Al+Ti+Ta+N+Te
refundir: Re+F+U+Nd+Ir
recentíssimo: Re+Ce+N+Ti+S+Si+Mo | Re+Ce+N+Ti+S+S+I+Mo
Pogues: P+Og+U+Es
Focus: F+O+Cu+S | F+O+C+U+S
cócega: C+O+Ce+Ga | Co+Ce+Ga
botânica: B+O+Ta+Ni+Ca | B+O+Ta+N+I+Ca
bop: B+O+P
Bolinhas: B+O+Li+Nh+As | B+O+Li+N+H+As
talibã: Ta+Li+Ba
Steffi: S+Te+F+F+I
solver: S+O+Lv+Er
Serrão: S+Er+Ra+O
Representante: Re+P+Re+Se+N+Ta+N+Te
reclamo: Re+C+La+Mo | Re+Cl+Am+O
Oliver: O+Li+V+Er
no: No | N+O
Nóbrega: N+O+B+Re+Ga | No+B+Re+Ga
montanhismo: Mo+N+Ta+N+H+I+S+Mo | Mo+N+Ta+Nh+I+Sm+O | Mo+N+Ta+Nh+I+S+Mo | Mo+N+Ta+N+H+I+Sm+O
Lavra: La+V+Ra
Hi: H+I
famosíssimo: F+Am+O+S+I+S+S+I+Mo | F+Am+Os+I+S+Si+Mo | F+Am+O+Si+S+S+I+Mo | F+Am+O+Si+S+Si+Mo | F+Am+O+S+I+S+Si+Mo | F+Am+Os+I+S+S+I+Mo
cretino: C+Re+Ti+N+O | C+Re+Ti+No
cisco: C+I+S+Co | C+I+S+C+O | C+I+Sc+O
catalã: Ca+Ta+La
Besirovic: Be+S+Ir+O+V+I+C | B+Es+Ir+O+V+I+C
asceta: As+Ce+Ta
Arrabal: Ar+Ra+B+Al
alcalino: Al+C+Al+I+No | Al+C+Al+In+O | Al+Ca+Li+No | Al+C+Al+I+N+O | Al+Ca+Li+N+O
tina: Ti+Na
Tibi: Ti+B+I | Ti+Bi
saltear: S+Al+Te+Ar
Rabbani: Ra+B+Ba+N+I | Ra+B+Ba+Ni
Professora: Pr+O+F+Es+S+O+Ra | Pr+O+Fe+S+S+O+Ra
Pik: P+I+K
ibero: I+B+Er+O
ganancioso: Ga+Na+N+C+I+O+S+O | Ga+Na+N+C+I+Os+O
Gabinete: Ga+B+I+Ne+Te | Ga+Bi+Ne+Te
fosco: F+Os+Co | F+O+S+C+O | F+O+S+Co | F+Os+C+O | F+O+Sc+O
fetichista: Fe+Ti+C+H+I+S+Ta
Cheney: C+He+Ne+Y
canícula: Ca+Ni+Cu+La | Ca+N+I+Cu+La | Ca+N+I+C+U+La | Ca+Ni+C+U+La
calvinista: C+Al+V+I+Ni+S+Ta | Ca+Lv+In+I+S+Ta | C+Al+V+In+I+S+Ta | Ca+Lv+I+N+I+S+Ta | C+Al+V+I+N+I+S+Ta | Ca+Lv+I+Ni+S+Ta
br: Br
bas: B+As | Ba+S
baboso: Ba+B+Os+O | Ba+B+O+S+O
Access: Ac+Ce+S+S | Ac+C+Es+S
vinco: V+I+N+C+O | V+In+C+O | V+In+Co | V+I+N+Co
sinusite: S+I+N+U+S+I+Te | S+I+N+U+Si+Te | Si+N+U+Si+Te | S+In+U+Si+Te | Si+N+U+S+I+Te | S+In+U+S+I+Te
sheik: S+He+I+K
reaccionarismo: Re+Ac+C+I+O+N+Ar+I+Sm+O | Re+Ac+C+I+O+N+Ar+I+S+Mo
previsional: P+Re+V+I+Si+O+N+Al | P+Re+V+I+S+I+O+N+Al
politeísmo: P+O+Li+Te+I+S+Mo | Po+Li+Te+I+S+Mo | P+O+Li+Te+I+Sm+O | Po+Li+Te+I+Sm+O
Nise: Ni+Se | N+I+Se
mofino: Mo+F+In+O | Mo+F+I+N+O | Mo+F+I+No
Lila: Li+La
hou: H+O+U | Ho+U
fátuo: F+At+U+O
Crestins: Cr+Es+Ti+N+S | C+Re+S+Ti+N+S
Cincinnati: C+In+C+In+N+At+I | C+In+C+I+N+N+At+I | C+I+N+C+In+N+At+I | C+I+N+C+I+N+N+At+I | C+I+N+C+I+N+Na+Ti | C+In+C+In+Na+Ti | C+I+N+C+In+Na+Ti
ceroulas: C+Er+O+U+La+S
Cernache: C+Er+Na+C+He | Ce+Rn+Ac+He | C+Er+N+Ac+He
caminheiro: C+Am+I+N+He+Ir+O | C+Am+In+He+Ir+O
cambista: C+Am+B+I+S+Ta | C+Am+Bi+S+Ta
bofe: B+O+Fe
beiral: Be+Ir+Al
Sogeval: S+O+Ge+V+Al
ruina: Ru+I+Na
protéico: Pr+O+Te+I+Co | Pr+O+Te+I+C+O
pratinho: Pr+At+In+Ho | P+Ra+Ti+N+H+O | Pr+At+I+N+H+O | Pr+At+In+H+O | P+Ra+Ti+Nh+O | Pr+At+I+Nh+O | P+Ra+Ti+N+Ho | Pr+At+I+N+Ho
Pias: P+I+As
Pialat: P+I+Al+At
perfeccionismo: P+Er+Fe+C+C+I+O+N+I+S+Mo | P+Er+Fe+C+C+I+O+Ni+S+Mo | P+Er+Fe+C+C+I+O+Ni+Sm+O | P+Er+Fe+C+C+I+O+N+I+Sm+O
Passeio: P+As+Se+I+O | Pa+S+Se+I+O
narcisista: N+Ar+C+I+Si+S+Ta | N+Ar+C+I+S+I+S+Ta
momo: Mo+Mo
librar: Li+Br+Ar
Laser: La+S+Er
Kiss: K+I+S+S
Kiptanui: K+I+P+Ta+N+U+I
ice: I+Ce
Florestas: Fl+O+Re+S+Ta+S
Falstaff: F+Al+S+Ta+F+F
Cunene: Cu+Ne+Ne | C+U+Ne+Ne
carbônico: C+Ar+B+O+N+I+Co | Ca+Rb+O+Ni+Co | Ca+Rb+O+N+I+Co | C+Ar+B+O+N+I+C+O | Ca+Rb+O+Ni+C+O | C+Ar+B+O+Ni+C+O | Ca+Rb+O+N+I+C+O
Calhau: C+Al+H+Au
Albertini: Al+B+Er+Ti+N+I | Al+B+Er+Ti+Ni
Sunderland: S+U+Nd+Er+La+Nd
refundar: Re+F+U+Nd+Ar
Nicola: N+I+C+O+La | Ni+Co+La | Ni+C+O+La | N+I+Co+La
eunuco: Eu+N+U+C+O | Eu+N+U+Co
coiro: Co+Ir+O | C+O+Ir+O
Cheers: C+He+Er+S
Carver: C+Ar+V+Er
Capriati: Ca+Pr+I+At+I
Brooks: Br+O+O+K+S
Brescialat: Br+Es+C+I+Al+At | B+Re+S+C+I+Al+At | B+Re+Sc+I+Al+At
Borg: B+O+Rg
Www: W+W+W
Wu: W+U
Ual: U+Al
taberneiro: Ta+B+Er+Ne+Ir+O
séptico: Se+P+Ti+Co | Se+Pt+I+Co | Se+Pt+I+C+O | Se+P+Ti+C+O
Serifo: S+Er+I+F+O
seráfico: Se+Ra+F+I+C+O | Se+Ra+F+I+Co
Senete: Se+Ne+Te
Press: P+Re+S+S | Pr+Es+S
Paganini: Pa+Ga+N+I+Ni | Pa+Ga+Ni+Ni | Pa+Ga+Ni+N+I | Pa+Ga+N+I+N+I | Pa+Ga+N+In+I
offshore: O+F+F+S+H+O+Re | O+F+F+S+Ho+Re
nobiliário: No+B+I+Li+Ar+I+O | N+O+Bi+Li+Ar+I+O | N+O+B+I+Li+Ar+I+O | No+Bi+Li+Ar+I+O
Koresh: K+O+Re+S+H
geneticista: Ge+Ne+Ti+C+I+S+Ta
Gene: Ge+Ne
Galinheiras: Ga+Li+N+He+I+Ra+S | Ga+Li+N+He+Ir+As
Ferguson: Fe+Rg+U+S+O+N
Erasmo: Er+As+Mo
Céu: Ce+U | C+Eu
Creoula: C+Re+O+U+La
cognac: C+Og+Na+C | C+Og+N+Ac
clinicar: Cl+I+N+I+C+Ar | Cl+I+Ni+C+Ar | C+Li+N+I+C+Ar | Cl+In+I+C+Ar | C+Li+Ni+C+Ar
bisca: B+I+S+Ca | Bi+S+Ca
bicéfalo: B+I+Ce+F+Al+O | Bi+Ce+F+Al+O
Barreirense: B+Ar+Re+I+Re+N+Se
Alagoas: Al+Ag+O+As
timo: Ti+Mo
Salonen: S+Al+O+Ne+N
salomônico: S+Al+O+Mo+N+I+C+O | S+Al+O+Mo+N+I+Co | S+Al+O+Mo+Ni+Co | S+Al+O+Mo+Ni+C+O
policiarista: P+O+Li+C+I+Ar+I+S+Ta | Po+Li+C+I+Ar+I+S+Ta
patinho: P+At+I+N+Ho | P+At+I+N+H+O | P+At+In+H+O | P+At+In+Ho | Pa+Ti+N+H+O | P+At+I+Nh+O | Pa+Ti+N+Ho | Pa+Ti+Nh+O
Nota: No+Ta | N+O+Ta
Latina: La+Ti+Na
insalubre: In+S+Al+U+B+Re | I+N+S+Al+U+B+Re
Inforgal: I+N+F+O+Rg+Al | In+F+O+Rg+Al
ibi: I+B+I | I+Bi
escovar: Es+Co+V+Ar | Es+C+O+V+Ar
erat: Er+At
burundês: B+U+Ru+Nd+Es
Braval: B+Ra+V+Al
Bra: B+Ra
tita: Ti+Ta
remoinho: Re+Mo+I+N+Ho | Re+Mo+In+H+O | Re+Mo+I+N+H+O | Re+Mo+I+Nh+O | Re+Mo+In+Ho
preponderar: P+Re+P+O+Nd+Er+Ar | P+Re+Po+Nd+Er+Ar
laconismo: La+C+O+N+I+Sm+O | La+C+O+N+I+S+Mo | La+Co+Ni+S+Mo | La+C+O+Ni+S+Mo | La+Co+N+I+S+Mo | La+Co+N+I+Sm+O | La+Co+Ni+Sm+O
Foy: F+O+Y
foreiro: F+O+Re+Ir+O
Corgo: C+O+Rg+O | Co+Rg+O
cabalístico: Ca+B+Al+I+S+Ti+C+O | Ca+Ba+Li+S+Ti+Co | Ca+Ba+Li+S+Ti+C+O | Ca+B+Al+I+S+Ti+Co
Buba: B+U+Ba
Balibó: B+Al+I+B+O | Ba+Li+B+O
Bac: Ba+C | B+Ac
altaneiro: Al+Ta+Ne+Ir+O
vu: V+U
ático: At+I+Co | At+I+C+O
slick: S+Li+C+K
senderista: Se+Nd+Er+I+S+Ta
sacola: S+Ac+O+La
rand: Ra+Nd
psicoterapeuta: P+S+I+Co+Te+Ra+P+Eu+Ta | P+Si+Co+Te+Ra+P+Eu+Ta | P+S+I+C+O+Te+Ra+P+Eu+Ta | P+Si+C+O+Te+Ra+P+Eu+Ta
Professores: Pr+O+F+Es+S+O+Re+S | Pr+O+Fe+S+S+O+Re+S
núbio: N+U+Bi+O | N+U+B+I+O
Ipswich: I+P+S+W+I+C+H
incender: I+N+Ce+Nd+Er | In+Ce+Nd+Er
funéreo: F+U+Ne+Re+O
Capirossi: Ca+P+Ir+O+S+Si | Ca+P+Ir+O+S+S+I | Ca+P+Ir+Os+Si | Ca+P+Ir+Os+S+I
Calais: Ca+La+I+S
bretã: B+Re+Ta
Acop: Ac+O+P
titler: Ti+Tl+Er
tamto: Ta+Mt+O
tacanho: Ta+Ca+Nh+O | Ta+Ca+N+H+O | Ta+Ca+N+Ho
Taba: Ta+Ba
socapa: S+O+Ca+Pa
soarismo: S+O+Ar+I+S+Mo | S+O+Ar+I+Sm+O
Ruben: Ru+Be+N
rena: Re+Na
ranhura: Ra+Nh+U+Ra | Ra+N+H+U+Ra
Ramon: Ra+Mo+N
plaga: P+La+Ga
Nora: N+O+Ra | No+Ra
copista: C+O+P+I+S+Ta | Co+P+I+S+Ta
Clóvis: Cl+O+V+I+S
Chéreau: C+He+Re+Au
carranca: C+Ar+Ra+N+Ca
carão: Ca+Ra+O
cabotino: Ca+B+O+Ti+N+O | Ca+B+O+Ti+No
bucho: B+U+C+Ho | B+U+C+H+O
Bierhoff: Bi+Er+H+O+F+F | B+I+Er+H+O+F+F | B+I+Er+Ho+F+F | Bi+Er+Ho+F+F
barbo: Ba+Rb+O | B+Ar+B+O
ascetismo: As+Ce+Ti+Sm+O | As+Ce+Ti+S+Mo
windsurfista: W+In+Ds+U+Rf+I+S+Ta | W+I+N+Ds+U+Rf+I+S+Ta | W+I+Nd+S+U+Rf+I+S+Ta
uos: U+O+S | U+Os
thatcherismo: Th+At+C+H+Er+I+S+Mo | Th+At+C+H+Er+I+Sm+O
supervisar: S+U+P+Er+V+I+S+Ar
sindicar: S+I+Nd+I+C+Ar | Si+Nd+I+C+Ar
prensar: P+Re+N+S+Ar
PanAm: Pa+N+Am
nervura: N+Er+V+U+Ra
Huber: H+U+B+Er
forasteira: F+O+Ra+S+Te+I+Ra
fontismo: F+O+N+Ti+S+Mo | F+O+N+Ti+Sm+O
cona: C+O+Na | Co+Na
Cesar: C+Es+Ar | Ce+S+Ar
Caribe: C+Ar+I+Be
biliar: B+I+Li+Ar | Bi+Li+Ar
bicheiro: B+I+C+He+Ir+O | Bi+C+He+Ir+O
Barnabé: B+Ar+Na+Be
bá: Ba
ascese: As+Ce+Se
Alvaro: Al+V+Ar+O
Yves: Y+V+Es
Sui: S+U+I
Spirou: S+P+Ir+O+U
punch: Pu+N+C+H | P+U+N+C+H
publicista: Pu+B+Li+C+I+S+Ta | P+U+B+Li+C+I+S+Ta
Progresso: Pr+Og+Re+S+S+O
principesco: Pr+I+N+C+I+P+Es+Co | Pr+In+C+I+P+Es+Co | Pr+In+C+I+P+Es+C+O | Pr+I+N+C+I+P+Es+C+O
pálio: Pa+Li+O | P+Al+I+O
ofuscante: O+F+U+S+Ca+N+Te
Io: I+O
inflacionário: In+Fl+Ac+I+O+N+Ar+I+O | I+N+F+La+C+I+O+N+Ar+I+O | In+F+La+C+I+O+N+Ar+I+O | I+N+Fl+Ac+I+O+N+Ar+I+O
Hipócrates: H+I+Po+Cr+At+Es | H+I+Po+C+Ra+Te+S | H+I+P+O+Cr+At+Es | H+I+P+O+C+Ra+Te+S
falsete: F+Al+Se+Te
Espero: Es+P+Er+O
cético: Ce+Ti+Co | Ce+Ti+C+O
Covões: C+O+V+O+Es | Co+V+O+Es
copinho: Co+P+I+N+H+O | Co+P+In+H+O | C+O+P+I+N+H+O | Co+P+I+Nh+O | C+O+P+I+Nh+O | C+O+P+I+N+Ho | Co+P+In+Ho | C+O+P+In+Ho | Co+P+I+N+Ho | C+O+P+In+H+O
Conacri: C+O+Na+Cr+I | Co+Na+Cr+I
Cobain: Co+Ba+I+N | C+O+Ba+In | Co+Ba+In | C+O+Ba+I+N
Bresson: B+Re+S+S+O+N | Br+Es+S+O+N
bílis: B+I+Li+S | Bi+Li+S
arrecear: Ar+Re+Ce+Ar
alpinismo: Al+P+In+I+Sm+O | Al+P+I+Ni+S+Mo | Al+P+I+N+I+Sm+O | Al+P+I+Ni+Sm+O | Al+P+In+I+S+Mo | Al+P+I+N+I+S+Mo
Yuran: Y+U+Ra+N
Viso: V+I+S+O
Tão: Ta+O
Tindersticks: Ti+Nd+Er+S+Ti+C+K+S
Thyssen: Th+Y+S+Se+N
Terêncio: Te+Re+N+C+I+O
Reti: Re+Ti
Raymond: Ra+Y+Mo+Nd
prà: P+Ra
polaina: P+O+La+I+Na | Po+La+I+Na
Patacas: Pa+Ta+C+As | P+At+Ac+As | Pa+Ta+Ca+S
montanhista: Mo+N+Ta+N+H+I+S+Ta | Mo+N+Ta+Nh+I+S+Ta
lupanar: Lu+Pa+N+Ar
Lúcifer: Lu+C+I+F+Er
kalashnikov: K+Al+As+H+N+I+K+O+V | K+Al+As+H+Ni+K+O+V
Irina: Ir+I+Na
ficaraõ: F+I+Ca+Ra+O
escrete: Es+C+Re+Te
Coura: C+O+U+Ra | Co+U+Ra
Clipper: Cl+I+P+P+Er | C+Li+P+P+Er
civilista: C+I+V+I+Li+S+Ta
Carina: C+Ar+I+Na
Berlin: B+Er+Li+N
Acre: Ac+Re
Viver: V+I+V+Er
Sindicatos: S+I+Nd+I+C+At+O+S | Si+Nd+I+C+At+O+S | S+I+Nd+I+C+At+Os | Si+Nd+I+C+At+Os
samaritano: S+Am+Ar+I+Ta+No | S+Am+Ar+I+Ta+N+O
Ruth: Ru+Th
prélio: P+Re+Li+O
pitéu: P+I+Te+U
pernoita: P+Er+No+I+Ta | P+Er+N+O+I+Ta
Park: P+Ar+K
mourão: Mo+U+Ra+O
Monte: Mo+N+Te
moca: Mo+Ca
lascar: La+S+C+Ar | La+Sc+Ar
labuta: La+B+U+Ta
Hitachi: H+I+Ta+C+H+I
Francos: F+Ra+N+C+O+S | F+Ra+N+C+Os | F+Ra+N+Co+S
fIP: F+I+P
Essas: Es+S+As
Céus: C+Eu+S | Ce+U+S
Câmaras: C+Am+Ar+As
Bengala: Be+N+Ga+La
bateira: Ba+Te+I+Ra
American: Am+Er+I+Ca+N
Alcains: Al+Ca+I+N+S | Al+Ca+In+S
