ser: S+Er
para: Pa+Ra
não: Na+O
se: Se
seu: S+Eu
este: Es+Te
como: C+O+Mo
ir: Ir
ou: O+U
eu: Eu
sobre: S+O+B+Re
esse: Es+Se
novo: N+O+V+O
ver: V+Er
só: S+O
país: Pa+I+S
pouco: P+O+U+C+O
passar: P+As+S+Ar
vir: V+Ir
ficar: F+I+C+Ar
isso: I+S+S+O
parte: P+Ar+Te
nós: N+O+S
agora: Ag+O+Ra
caso: C+As+O
público: P+U+B+Li+C+O
político: P+O+Li+Ti+C+O
parecer: Pa+Re+C+Er
próprio: Pr+O+Pr+I+O
nosso: N+O+S+S+O
continuar: C+O+N+Ti+N+U+Ar
cerca: C+Er+Ca
final: F+In+Al
obra: O+B+Ra
processo: Pr+O+C+Es+S+O
falar: F+Al+Ar
hora: H+O+Ra
nacional: N+Ac+I+O+N+Al
tão: Ta+O
conhecer: C+O+N+He+C+Er
Público: P+U+B+Li+C+O
nunca: N+U+N+Ca
receber: Re+Ce+B+Er
social: S+O+C+I+Al
noite: N+O+I+Te
único: U+N+I+C+O
principal: Pr+In+C+I+P+Al
prever: P+Re+V+Er
viver: V+I+V+Er
esperar: Es+P+Er+Ar
acontecer: Ac+O+N+Te+C+Er
pois: P+O+I+S
cinco: C+In+C+O
criar: Cr+I+Ar
lá: La
referir: Re+F+Er+Ir
política: P+O+Li+Ti+Ca
proposta: Pr+O+P+O+S+Ta
ganhar: Ga+N+H+Ar
frente: F+Re+N+Te
fora: F+O+Ra
através: At+Ra+V+Es
conta: C+O+N+Ta
francês: F+Ra+N+C+Es
ouvir: O+U+V+Ir
início: In+I+C+I+O
internacional: In+Te+Rn+Ac+I+O+N+Al
pretender: P+Re+Te+Nd+Er
escrever: Es+C+Re+V+Er
escola: Es+C+O+La
necessário: Ne+C+Es+S+Ar+I+O
pagar: P+Ag+Ar
técnico: Te+C+N+I+C+O
chamar: C+H+Am+Ar
palavra: Pa+La+V+Ra
plano: P+La+N+O
falta: F+Al+Ta
interesse: In+Te+Re+S+Se
seis: Se+I+S
surgir: S+U+Rg+Ir
tipo: Ti+P+O
fundo: F+U+Nd+O
servir: S+Er+V+Ir
sob: S+O+B
incluir: In+C+Lu+Ir
vários: V+Ar+I+O+S
responder: Re+S+P+O+Nd+Er
claro: Cl+Ar+O
pai: Pa+I
clube: C+Lu+Be
gente: Ge+N+Te
acusar: Ac+U+S+Ar
socialista: S+O+C+I+Al+I+S+Ta
ali: Al+I
campo: C+Am+P+O
participar: P+Ar+Ti+C+I+P+Ar
financeiro: F+I+Na+N+Ce+Ir+O
americano: Am+Er+I+Ca+N+O
presente: P+Re+Se+N+Te
princípio: Pr+In+C+I+P+I+O
base: Ba+Se
fonte: F+O+N+Te
provocar: Pr+O+V+O+C+Ar
várias: V+Ar+I+As
concluir: C+O+N+C+Lu+Ir
resposta: Re+S+P+O+S+Ta
achar: Ac+H+Ar
povo: P+O+V+O
resolver: Re+S+O+Lv+Er
oficial: O+F+I+C+I+Al
reconhecer: Re+C+O+N+He+C+Er
Benfica: Be+N+F+I+Ca
carta: C+Ar+Ta
caminho: C+Am+In+H+O
publicar: P+U+B+Li+C+Ar
banco: Ba+N+C+O
cair: Ca+Ir
luta: Lu+Ta
preciso: P+Re+C+I+S+O
usar: U+S+Ar
sofrer: S+O+Fr+Er
lista: Li+S+Ta
assinar: As+Si+N+Ar
reunir: Re+U+N+Ir
ambos: Am+B+O+S
sete: Se+Te
chefe: C+He+Fe
acesso: Ac+Es+S+O
ocupar: O+C+U+P+Ar
profissional: Pr+O+F+I+S+Si+O+N+Al
crise: Cr+I+Se
preparar: P+Re+P+Ar+Ar
subir: S+U+B+Ir
pessoal: P+Es+S+O+Al
aliás: Al+I+As
visita: V+I+Si+Ta
sublinhar: S+U+B+Li+N+H+Ar
representante: Re+P+Re+Se+N+Ta+N+Te
aluno: Al+U+N+O
recente: Re+Ce+N+Te
iniciar: In+I+C+I+Ar
nascer: N+As+C+Er
hipótese: H+I+P+O+Te+Se
funcionar: F+U+N+C+I+O+N+Ar
britânico: Br+I+Ta+N+I+C+O
sinal: Si+N+Al
gestão: Ge+S+Ta+O
bastante: B+As+Ta+N+Te
arte: Ar+Te
branco: B+Ra+N+C+O
livre: Li+V+Re
oferecer: O+Fe+Re+C+Er
real: Re+Al
verificar: V+Er+I+F+I+C+Ar
cargo: Ca+Rg+O
russo: Ru+S+S+O
fechar: Fe+C+H+Ar
precisar: P+Re+C+I+S+Ar
promover: Pr+O+Mo+V+Er
ar: Ar
passo: P+As+S+O
festa: F+Es+Ta
restante: Re+S+Ta+N+Te
bater: B+At+Er
vós: V+O+S
indicar: I+Nd+I+C+Ar
vista: V+I+S+Ta
prática: P+Ra+Ti+Ca
funcionário: F+U+N+C+I+O+N+Ar+I+O
recusar: Re+C+U+S+Ar
teu: Te+U
carreira: C+Ar+Re+I+Ra
Paris: P+Ar+I+S
fogo: F+Og+O
motivo: Mo+Ti+V+O
centena: Ce+N+Te+Na
sucesso: S+U+C+Es+S+O
valer: V+Al+Er
crítica: Cr+I+Ti+Ca
interno: In+Te+Rn+O
vivo: V+I+V+O
positivo: P+O+Si+Ti+V+O
pertencer: P+Er+Te+N+C+Er
sérvio: S+Er+V+I+O
parar: P+Ar+Ar
pobre: P+O+B+Re
rei: Re+I
ora: O+Ra
perceber: P+Er+Ce+B+Er
preferir: P+Re+F+Er+Ir
canal: Ca+N+Al
crescer: C+Re+S+C+Er
vosso: V+O+S+S+O
revista: Re+V+I+S+Ta
bola: B+O+La
recuperar: Re+C+U+P+Er+Ar
relativo: Re+La+Ti+V+O
crítico: Cr+I+Ti+C+O
possuir: P+O+S+S+U+Ir
artista: Ar+Ti+S+Ta
verba: V+Er+Ba
prender: P+Re+Nd+Er
causar: C+Au+S+Ar
caber: Ca+B+Er
peso: P+Es+O
página: P+Ag+I+Na
Braga: B+Ra+Ga
república: Re+P+U+B+Li+Ca
provar: Pr+O+V+Ar
criticar: Cr+I+Ti+C+Ar
fronteira: Fr+O+N+Te+I+Ra
índice: I+Nd+I+Ce
interessar: In+Te+Re+S+S+Ar
atrás: At+Ra+S
cenário: Ce+N+Ar+I+O
nota: N+O+Ta
ponte: P+O+N+Te
sério: S+Er+I+O
largo: La+Rg+O
cena: Ce+Na
cá: Ca
preocupar: P+Re+O+C+U+P+Ar
general: Ge+N+Er+Al
procura: Pr+O+C+U+Ra
senhora: Se+N+H+O+Ra
referendo: Re+Fe+Re+Nd+O
classe: C+La+S+Se
fiscal: F+I+S+C+Al
visar: V+I+S+Ar
sindicato: Si+Nd+I+C+At+O
profundo: Pr+O+F+U+Nd+O
palco: P+Al+C+O
foi: F+O+I
esclarecer: Es+C+La+Re+C+Er
essencial: Es+Se+N+C+I+Al
cheio: C+He+I+O
gabinete: Ga+B+I+Ne+Te
familiar: F+Am+I+Li+Ar
atraso: At+Ra+S+O
accionista: Ac+C+I+O+N+I+S+Ta
receita: Re+Ce+I+Ta
cabo: Ca+B+O
esconder: Es+C+O+Nd+Er
consumo: C+O+N+S+U+Mo
cobrir: C+O+Br+Ir
céu: C+Eu
classificar: C+La+S+Si+F+I+C+Ar
atuar: At+U+Ar
crer: Cr+Er
salário: S+Al+Ar+I+O
negativo: Ne+Ga+Ti+V+O
alvo: Al+V+O
activo: Ac+Ti+V+O
praticar: P+Ra+Ti+C+Ar
vinho: V+In+H+O
observar: O+B+S+Er+V+Ar
optar: O+Pt+Ar
ciclo: C+I+Cl+O
físico: F+I+Si+C+O
chinês: C+H+In+Es
beneficiar: Be+Ne+F+I+C+I+Ar
atravessar: At+Ra+V+Es+S+Ar
China: C+H+I+Na
pp: P+P
sonho: S+O+N+H+O
montante: Mo+N+Ta+N+Te
atacar: At+Ac+Ar
inicial: In+I+C+I+Al
uso: U+S+O
casar: C+As+Ar
relacionar: Re+La+C+I+O+N+Ar
incêndio: In+Ce+Nd+I+O
Bruxelas: B+Ru+Xe+La+S
ligeiro: Li+Ge+Ir+O
senão: Se+Na+O
honra: H+O+N+Ra
assinalar: As+Si+N+Al+Ar
Unita: U+N+I+Ta
viatura: V+I+At+U+Ra
salvar: S+Al+V+Ar
frio: Fr+I+O
clássico: C+La+S+Si+C+O
confessar: C+O+N+F+Es+S+Ar
policial: P+O+Li+C+I+Al
posse: P+O+S+Se
convocar: C+O+N+V+O+C+Ar
timorense: Ti+Mo+Re+N+Se
católico: C+At+O+Li+C+O
Moscovo: Mo+S+C+O+V+O
falso: F+Al+S+O
parceiro: P+Ar+Ce+Ir+O
oferta: O+F+Er+Ta
bispo: B+I+S+P+O
amar: Am+Ar
barco: B+Ar+C+O
festival: F+Es+Ti+V+Al
teste: Te+S+Te
participante: P+Ar+Ti+C+I+Pa+N+Te
assinatura: As+Si+N+At+U+Ra
indonésio: I+Nd+O+N+Es+I+O
sindical: Si+Nd+I+C+Al
género: Ge+N+Er+O
fraco: F+Ra+C+O
famoso: F+Am+O+S+O
reagir: Re+Ag+Ir
você: V+O+Ce
pista: P+I+S+Ta
arrancar: Ar+Ra+N+C+Ar
separar: Se+P+Ar+Ar
reclamar: Re+Cl+Am+Ar
inteiro: In+Te+Ir+O
virar: V+Ir+Ar
constante: C+O+N+S+Ta+N+Te
pesar: P+Es+Ar
par: P+Ar
convite: C+O+N+V+I+Te
navio: Na+V+I+O
lucro: Lu+Cr+O
vinte: V+In+Te
visitante: V+I+Si+Ta+N+Te
boca: B+O+Ca
restaurante: Re+S+Ta+U+Ra+N+Te
associar: As+S+O+C+I+Ar
frase: F+Ra+Se
Cavaco: Ca+V+Ac+O
secundário: Se+C+U+Nd+Ar+I+O
proibir: Pr+O+I+B+Ir
cristão: Cr+I+S+Ta+O
cartão: C+Ar+Ta+O
sítio: Si+Ti+O
sócio: S+O+C+I+O
falhar: F+Al+H+Ar
gás: Ga+S
tese: Te+Se
buscar: B+U+S+C+Ar
vila: V+I+La
Viseu: V+I+S+Eu
basear: Ba+Se+Ar
casal: C+As+Al
liga: Li+Ga
feira: Fe+I+Ra
bancário: Ba+N+C+Ar+I+O
atirar: At+Ir+Ar
ferir: F+Er+Ir
crescente: C+Re+S+Ce+N+Te
cara: Ca+Ra
técnica: Te+C+N+I+Ca
fé: Fe
caro: C+Ar+O
beber: Be+B+Er
holandês: H+O+La+Nd+Es
nato: N+At+O
fuga: F+U+Ga
reservar: Re+S+Er+V+Ar
escapar: Es+Ca+P+Ar
árvore: Ar+V+O+Re
carne: C+Ar+Ne
universo: U+N+I+V+Er+S+O
continente: C+O+N+Ti+Ne+N+Te
básico: B+As+I+C+O
aula: Au+La
variar: V+Ar+I+Ar
Soares: S+O+Ar+Es
acaso: Ac+As+O
cavalo: Ca+V+Al+O
artístico: Ar+Ti+S+Ti+C+O
papa: Pa+Pa
patente: Pa+Te+N+Te
carga: C+Ar+Ga
receio: Re+Ce+I+O
benefício: Be+Ne+F+I+C+I+O
liberal: Li+B+Er+Al
rapariga: Ra+P+Ar+I+Ga
acerca: Ac+Er+Ca
palácio: P+Al+Ac+I+O
busca: B+U+S+Ca
oh: O+H
América: Am+Er+I+Ca
seio: Se+I+O
consenso: C+O+N+Se+N+S+O
escala: Es+Ca+La
noticiar: N+O+Ti+C+I+Ar
pronunciar: Pr+O+N+U+N+C+I+Ar
progresso: Pr+Og+Re+S+S+O
estender: Es+Te+Nd+Er
costas: C+O+S+Ta+S
financiar: F+I+Na+N+C+I+Ar
intenso: In+Te+N+S+O
bar: B+Ar
café: Ca+Fe
nobre: N+O+B+Re
prático: P+Ra+Ti+C+O
fundar: F+U+Nd+Ar
motivar: Mo+Ti+V+Ar
herói: H+Er+O+I
escândalo: Es+Ca+Nd+Al+O
frisar: Fr+I+S+Ar
operar: O+P+Er+Ar
óbvio: O+B+V+I+O
pesca: P+Es+Ca
conceber: C+O+N+Ce+B+Er
reino: Re+In+O
perna: P+Er+Na
passeio: P+As+Se+I+O
capitão: Ca+P+I+Ta+O
franco: F+Ra+N+C+O
fecho: Fe+C+H+O
rever: Re+V+Er
plástico: P+La+S+Ti+C+O
bosnio: B+O+S+N+I+O
barreira: B+Ar+Re+I+Ra
conservar: C+O+N+S+Er+V+Ar
camarário: C+Am+Ar+Ar+I+O
inspirar: In+S+P+Ir+Ar
pacífico: P+Ac+I+F+I+C+O
sucessivo: S+U+C+Es+Si+V+O
alternativo: Al+Te+Rn+At+I+V+O
cancro: Ca+N+Cr+O
costa: C+O+S+Ta
cão: Ca+O
atrair: At+Ra+Ir
unir: U+N+Ir
condicionar: C+O+Nd+I+C+I+O+N+Ar
Natal: N+At+Al
Sampaio: S+Am+Pa+I+O
lance: La+N+Ce
agravar: Ag+Ra+V+Ar
ramo: Ra+Mo
autêntico: Au+Te+N+Ti+C+O
sobreviver: S+O+B+Re+V+I+V+Er
recear: Re+Ce+Ar
inscrever: In+S+C+Re+V+Er
vírus: V+I+Ru+S
republicano: Re+P+U+B+Li+Ca+N+O
agir: Ag+Ir
espalhar: Es+P+Al+H+Ar
Não: Na+O
consecutivo: C+O+N+Se+C+U+Ti+V+O
renovar: Re+N+O+V+Ar
convir: C+O+N+V+Ir
planeta: P+La+Ne+Ta
ascender: As+Ce+Nd+Er
monte: Mo+N+Te
mover: Mo+V+Er
invocar: In+V+O+C+Ar
poupar: P+O+U+P+Ar
hectare: He+C+Ta+Re
reparar: Re+P+Ar+Ar
tender: Te+Nd+Er
pressionar: P+Re+S+Si+O+N+Ar
recuar: Re+C+U+Ar
alinhar: Al+In+H+Ar
confiar: C+O+N+F+I+Ar
pacote: P+Ac+O+Te
escasso: Es+C+As+S+O
operário: O+P+Er+Ar+I+O
buraco: B+U+Ra+C+O
assassinar: As+S+As+Si+N+Ar
preso: P+Re+S+O
floresta: Fl+O+Re+S+Ta
sonhar: S+O+N+H+Ar
piso: P+I+S+O
clandestino: C+La+Nd+Es+Ti+N+O
verso: V+Er+S+O
proferir: Pr+O+F+Er+Ir
barato: B+Ar+At+O
banho: Ba+N+H+O
ponta: P+O+N+Ta
propina: Pr+O+P+I+Na
nacionalista: N+Ac+I+O+N+Al+I+S+Ta
reivindicar: Re+I+V+I+Nd+I+C+Ar
referente: Re+Fe+Re+N+Te
alheio: Al+He+I+O
salarial: S+Al+Ar+I+Al
alerta: Al+Er+Ta
atrasar: At+Ra+S+Ar
beira: Be+I+Ra
utente: U+Te+N+Te
biblioteca: B+I+B+Li+O+Te+Ca
pasta: P+As+Ta
célula: Ce+Lu+La
caminhar: C+Am+In+H+Ar
passe: P+As+Se
futebolista: F+U+Te+B+O+Li+S+Ta
parcial: P+Ar+C+I+Al
pão: Pa+O
ruptura: Ru+Pt+U+Ra
patrão: P+At+Ra+O
libra: Li+B+Ra
banca: Ba+N+Ca
conversar: C+O+N+V+Er+S+Ar
cigano: C+I+Ga+N+O
acrescer: Ac+Re+S+C+Er
conferir: C+O+N+F+Er+Ir
Cascais: C+As+Ca+I+S
subscrever: S+U+B+S+C+Re+V+Er
sugestão: S+U+Ge+S+Ta+O
contínuo: C+O+N+Ti+N+U+O
tabela: Ta+Be+La
prévio: P+Re+V+I+O
Cuba: C+U+Ba
vago: V+Ag+O
in: In
clínico: C+Li+N+I+C+O
vertente: V+Er+Te+N+Te
Monteiro: Mo+N+Te+Ir+O
rumo: Ru+Mo
fio: F+I+O
serra: S+Er+Ra
inserir: In+S+Er+Ir
instante: In+S+Ta+N+Te
confundir: C+O+N+F+U+Nd+Ir
saco: S+Ac+O
espacial: Es+P+Ac+I+Al
fresco: F+Re+S+C+O
cubano: C+U+Ba+N+O
ho: H+O
imobiliário: I+Mo+B+I+Li+Ar+I+O
cineasta: C+I+Ne+As+Ta
seco: Se+C+O
render: Re+Nd+Er
prata: P+Ra+Ta
ausente: Au+Se+N+Te
representativo: Re+P+Re+Se+N+Ta+Ti+V+O
potencial: P+O+Te+N+C+I+Al
irlandês: Ir+La+Nd+Es
universal: U+N+I+V+Er+S+Al
inverno: In+V+Er+N+O
polaco: P+O+La+C+O
brincar: Br+In+C+Ar
tencionar: Te+N+C+I+O+N+Ar
potenciar: P+O+Te+N+C+I+Ar
raio: Ra+I+O
asiático: As+I+At+I+C+O
preservar: P+Re+S+Er+V+Ar
barraca: B+Ar+Ra+Ca
voo: V+O+O
helicóptero: He+Li+C+O+Pt+Er+O
custa: C+U+S+Ta
ruína: Ru+I+Na
superar: S+U+P+Er+Ar
carteira: C+Ar+Te+I+Ra
ténis: Te+N+I+S
contente: C+O+N+Te+N+Te
ganho: Ga+N+H+O
escrita: Es+Cr+I+Ta
cansar: Ca+N+S+Ar
incentivo: In+Ce+N+Ti+V+O
coluna: C+O+Lu+Na
revolucionário: Re+V+O+Lu+C+I+O+N+Ar+I+O
escalão: Es+Ca+La+O
operacional: O+P+Er+Ac+I+O+N+Al
fila: F+I+La
per: P+Er
cobrar: C+O+Br+Ar
típico: Ti+P+I+C+O
piscina: P+I+S+C+I+Na
Genebra: Ge+Ne+B+Ra
nu: N+U
Irão: I+Ra+O
precioso: P+Re+C+I+O+S+O
heroína: H+Er+O+I+Na
voar: V+O+Ar
inocente: In+O+Ce+N+Te
atmosfera: At+Mo+S+Fe+Ra
assassínio: As+S+As+Si+N+I+O
alcance: Al+Ca+N+Ce
passear: P+As+Se+Ar
fino: F+In+O
pano: Pa+N+O
capa: Ca+Pa
censura: Ce+N+S+U+Ra
supremo: S+U+P+Re+Mo
frota: Fr+O+Ta
bebé: Be+Be
calhar: C+Al+H+Ar
tio: Ti+O
íntimo: In+Ti+Mo
aliar: Al+I+Ar
proclamar: Pr+O+Cl+Am+Ar
preocupante: P+Re+O+C+U+Pa+N+Te
processar: Pr+O+C+Es+S+Ar
ofício: O+F+I+C+I+O
estacionar: Es+Ta+C+I+O+N+Ar
cérebro: Ce+Re+Br+O
inteligente: In+Te+Li+Ge+N+Te
primo: Pr+I+Mo
asser: As+S+Er
cambial: C+Am+B+I+Al
planta: P+La+N+Ta
barra: B+Ar+Ra
albanês: Al+Ba+N+Es
fatal: F+At+Al
passivo: P+As+Si+V+O
prisioneiro: Pr+I+Si+O+Ne+Ir+O
cercar: C+Er+C+Ar
fracasso: F+Ra+C+As+S+O
largar: La+Rg+Ar
indício: I+Nd+I+C+I+O
sétimo: Se+Ti+Mo
Funchal: F+U+N+C+H+Al
calmo: C+Al+Mo
Espinho: Es+P+In+H+O
planear: P+La+Ne+Ar
argentino: Ar+Ge+N+Ti+N+O
catálogo: C+At+Al+Og+O
pop: P+O+P
nervoso: N+Er+V+O+S+O
estatística: Es+Ta+Ti+S+Ti+Ca
réu: Re+U
nó: N+O
placa: P+La+Ca
vário: V+Ar+I+O
cheiro: C+He+Ir+O
conduta: C+O+Nd+U+Ta
genético: Ge+Ne+Ti+C+O
opa: O+Pa
ousar: O+U+S+Ar
prato: Pr+At+O
argelino: Ar+Ge+Li+N+O
horas: H+O+Ra+S
lavar: La+V+Ar
ponderar: P+O+Nd+Er+Ar
balcão: B+Al+Ca+O
caos: Ca+O+S
soar: S+O+Ar
tabaco: Ta+B+Ac+O
Faro: F+Ar+O
vôo: V+O+O
cívico: C+I+V+I+C+O
ovo: O+V+O
fumo: F+U+Mo
assassino: As+S+As+Si+N+O
respirar: Re+S+P+Ir+Ar
substancial: S+U+B+S+Ta+N+C+I+Al
chefiar: C+He+F+I+Ar
Argentina: Ar+Ge+N+Ti+Na
chocar: C+H+O+C+Ar
professora: Pr+O+F+Es+S+O+Ra
assente: As+Se+N+Te
estético: Es+Te+Ti+C+O
fato: F+At+O
gene: Ge+Ne
punir: P+U+N+Ir
génio: Ge+N+I+O
indiferente: I+Nd+I+Fe+Re+N+Te
amiga: Am+I+Ga
agressivo: Ag+Re+S+Si+V+O
pertencente: P+Er+Te+N+Ce+N+Te
gasolina: Ga+S+O+Li+Na
Para: Pa+Ra
windows: W+I+Nd+O+W+S
lindo: Li+Nd+O
inferno: In+F+Er+N+O
Kosovo: K+O+S+O+V+O
copo: C+O+P+O
ofensivo: O+Fe+N+Si+V+O
calar: C+Al+Ar
cessar: C+Es+S+Ar
ambicioso: Am+B+I+C+I+O+S+O
acréscimo: Ac+Re+S+C+I+Mo
ciclista: C+I+C+Li+S+Ta
assaltante: As+S+Al+Ta+N+Te
capacete: Ca+Pa+Ce+Te
casaco: C+As+Ac+O
oeste: O+Es+Te
assistente: As+Si+S+Te+N+Te
captar: Ca+Pt+Ar
generoso: Ge+N+Er+O+S+O
visual: V+I+S+U+Al
Vaticano: V+At+I+Ca+N+O
nam: N+Am
foco: F+O+C+O
camisola: C+Am+I+S+O+La
progressivo: Pr+Og+Re+S+Si+V+O
Bush: B+U+S+H
pó: P+O
Famalicão: F+Am+Al+I+Ca+O
artificial: Ar+Ti+F+I+C+I+Al
Costa: C+O+S+Ta
barão: Ba+Ra+O
Bona: B+O+Na
osso: O+S+S+O
poste: P+O+S+Te
sindicalista: Si+Nd+I+C+Al+I+S+Ta
cocaína: C+O+Ca+I+Na
associativo: As+S+O+C+I+At+I+V+O
síntese: Si+N+Te+Se
tenista: Te+N+I+S+Ta
oitavo: O+I+Ta+V+O
racismo: Ra+C+I+S+Mo
convívio: C+O+N+V+I+V+I+O
geográfico: Ge+Og+Ra+F+I+C+O
senso: Se+N+S+O
vício: V+I+C+I+O
bala: Ba+La
mosteiro: Mo+S+Te+Ir+O
índio: I+Nd+I+O
sobrar: S+O+Br+Ar
criativo: Cr+I+At+I+V+O
arco: Ar+C+O
principiar: Pr+In+C+I+P+I+Ar
protestante: Pr+O+Te+S+Ta+N+Te
tecer: Te+C+Er
barba: B+Ar+Ba
pneu: P+N+Eu
Bundesbank: B+U+Nd+Es+Ba+N+K
precário: P+Re+C+Ar+I+O
reinar: Re+In+Ar
ratificar: Ra+Ti+F+I+C+Ar
boicote: B+O+I+C+O+Te
cofre: C+O+F+Re
nipônico: N+I+P+O+N+I+C+O
catalão: Ca+Ta+La+O
Barreiro: B+Ar+Re+Ir+O
sono: S+O+N+O
seita: Se+I+Ta
centenário: Ce+N+Te+N+Ar+I+O
febre: Fe+B+Re
sereno: Se+Re+N+O
sal: S+Al
genérico: Ge+N+Er+I+C+O
lábio: La+B+I+O
esfera: Es+Fe+Ra
realista: Re+Al+I+S+Ta
tinta: Ti+N+Ta
parcela: P+Ar+Ce+La
incentivar: In+Ce+N+Ti+V+Ar
oficina: O+F+I+C+I+Na
renunciar: Re+N+U+N+C+I+Ar
checo: C+He+C+O
socialismo: S+O+C+I+Al+I+S+Mo
activista: Ac+Ti+V+I+S+Ta
crucial: C+Ru+C+I+Al
recair: Re+Ca+Ir
paraíso: Pa+Ra+I+S+O
cerco: C+Er+C+O
pânico: Pa+N+I+C+O
confuso: C+O+N+F+U+S+O
prisional: Pr+I+Si+O+N+Al
prestes: P+Re+S+Te+S
recuo: Re+C+U+O
parente: Pa+Re+N+Te
Cairo: Ca+Ir+O
lira: Li+Ra
fruta: F+Ru+Ta
rali: Ra+Li
feita: Fe+I+Ta
escocês: Es+C+O+C+Es
atrever: At+Re+V+Er
indiciar: I+Nd+I+C+I+Ar
bando: Ba+Nd+O
mobiliário: Mo+B+I+Li+Ar+I+O
clínica: C+Li+N+I+Ca
separatista: Se+P+Ar+At+I+S+Ta
bracarense: B+Ra+Ca+Re+N+Se
congênere: C+O+N+Ge+Ne+Re
arcebispo: Ar+Ce+B+I+S+P+O
Camões: C+Am+O+Es
Líbano: Li+Ba+N+O
batata: Ba+Ta+Ta
Atlântico: At+La+N+Ti+C+O
rasgar: Ra+Sg+Ar
fita: F+I+Ta
obstante: O+B+S+Ta+N+Te
cláusula: C+La+U+S+U+La
Atlanta: At+La+N+Ta
hino: H+In+O
chover: C+H+O+V+Er
cais: Ca+I+S
escravo: Es+C+Ra+V+O
albergar: Al+Be+Rg+Ar
funeral: F+U+N+Er+Al
cassete: C+As+Se+Te
Nato: N+At+O
Renamo: Re+N+Am+O
severo: Se+V+Er+O
provir: Pr+O+V+Ir
ampliar: Am+P+Li+Ar
clarificar: Cl+Ar+I+F+I+C+Ar
tela: Te+La
lixeira: Li+Xe+I+Ra
capitalismo: Ca+P+I+Ta+Li+S+Mo
alívio: Al+I+V+I+O
findar: F+I+Nd+Ar
natal: N+At+Al
recluso: Re+C+Lu+S+O
latino: La+Ti+N+O
espólio: Es+P+O+Li+O
Castela: C+As+Te+La
monopólio: Mo+N+O+P+O+Li+O
Carvalhas: C+Ar+V+Al+H+As
Alverca: Al+V+Er+Ca
cura: C+U+Ra
Ippar: I+P+P+Ar
Se: Se
paralisar: P+Ar+Al+I+S+Ar
pároco: P+Ar+O+C+O
ofender: O+Fe+Nd+Er
Pacheco: P+Ac+He+C+O
naval: Na+V+Al
flagrante: Fl+Ag+Ra+N+Te
vacina: V+Ac+I+Na
ocupante: O+C+U+Pa+N+Te
vocacionar: V+O+C+Ac+I+O+N+Ar
finalista: F+In+Al+I+S+Ta
consensual: C+O+N+Se+N+S+U+Al
seca: Se+Ca
tc: Tc
licenciar: Li+Ce+N+C+I+Ar
resumo: Re+S+U+Mo
hos: H+O+S
feio: Fe+I+O
Unesco: U+N+Es+C+O
criatura: Cr+I+At+U+Ra
camponês: C+Am+P+O+N+Es
câmbio: C+Am+B+I+O
aliviar: Al+I+V+I+Ar
órbita: O+Rb+I+Ta
atrativo: At+Ra+Ti+V+O
escrutínio: Es+C+Ru+Ti+N+I+O
gerente: Ge+Re+N+Te
tapar: Ta+P+Ar
bacalhau: B+Ac+Al+H+Au
faro: F+Ar+O
finlandês: F+In+La+Nd+Es
noticioso: N+O+Ti+C+I+O+S+O
ficheiro: F+I+C+He+Ir+O
nono: N+O+N+O
regata: Re+Ga+Ta
racista: Ra+C+I+S+Ta
show: S+H+O+W
nacionalismo: N+Ac+I+O+N+Al+I+S+Mo
povoar: P+O+V+O+Ar
tático: Ta+Ti+C+O
conviver: C+O+N+V+I+V+Er
pairar: Pa+Ir+Ar
estatístico: Es+Ta+Ti+S+Ti+C+O
inerente: I+Ne+Re+N+Te
pisar: P+I+S+Ar
cautela: C+Au+Te+La
punho: P+U+N+H+O
volante: V+O+La+N+Te
carecer: Ca+Re+C+Er
foy: F+O+Y
Bissau: B+I+S+S+Au
viário: V+I+Ar+I+O
vocal: V+O+C+Al
luso: Lu+S+O
contingente: C+O+N+Ti+N+Ge+N+Te
ca: Ca
ibérico: I+B+Er+I+C+O
perverso: P+Er+V+Er+S+O
inclinar: In+C+Li+N+Ar
lã: La
captura: Ca+Pt+U+Ra
basco: B+As+C+O
rubrica: Ru+Br+I+Ca
fiar: F+I+Ar
bravo: B+Ra+V+O
Berlusconi: B+Er+Lu+S+C+O+N+I
bárbaro: B+Ar+B+Ar+O
sincero: Si+N+C+Er+O
casino: C+As+In+O
aspirar: As+P+Ir+Ar
volver: V+O+Lv+Er
sé: Se
lusitano: Lu+Si+Ta+N+O
Coliseu: C+O+Li+S+Eu
sec: Se+C
circo: C+Ir+C+O
sismo: Si+S+Mo
pau: P+Au
violino: V+I+O+Li+N+O
sofisticar: S+O+F+I+S+Ti+C+Ar
tchetcheno: Tc+He+Tc+He+N+O
sobrinho: S+O+Br+In+H+O
fisco: F+I+S+C+O
botão: B+O+Ta+O
inverso: In+V+Er+S+O
cirúrgico: C+I+Ru+Rg+I+C+O
gênero: Ge+N+Er+O
pátio: P+At+I+O
valioso: V+Al+I+O+S+O
Balcãs: B+Al+C+As
assassinato: As+S+As+Si+N+At+O
cerebral: Ce+Re+Br+Al
nervo: N+Er+V+O
crônico: Cr+O+N+I+C+O
sopa: S+O+Pa
irônico: Ir+O+N+I+C+O
soberano: S+O+Be+Ra+N+O
accionar: Ac+C+I+O+N+Ar
nascente: N+As+Ce+N+Te
Rabin: Ra+B+In
incendiar: In+Ce+Nd+I+Ar
réplica: Re+P+Li+Ca
Saramago: S+Ar+Am+Ag+O
inundar: In+U+Nd+Ar
espanhola: Es+Pa+N+H+O+La
Huambo: H+U+Am+B+O
licenciatura: Li+Ce+N+C+I+At+U+Ra
escusar: Es+C+U+S+Ar
bicho: B+I+C+H+O
praticante: P+Ra+Ti+Ca+N+Te
funcional: F+U+N+C+I+O+N+Al
Fernando: F+Er+Na+Nd+O
Sines: Si+N+Es
proteína: Pr+O+Te+I+Na
pescar: P+Es+C+Ar
sírio: S+Ir+I+O
parabéns: Pa+Ra+Be+N+S
betão: Be+Ta+O
cúbico: C+U+B+I+C+O
pioneiro: P+I+O+Ne+Ir+O
capitalista: Ca+P+I+Ta+Li+S+Ta
agrupar: Ag+Ru+P+Ar
acta: Ac+Ta
propício: Pr+O+P+I+C+I+O
fascista: F+As+C+I+S+Ta
pousar: P+O+U+S+Ar
preservativo: P+Re+S+Er+V+At+I+V+O
bota: B+O+Ta
salvo: S+Al+V+O
narrativo: N+Ar+Ra+Ti+V+O
colapso: C+O+La+P+S+O
céptico: Ce+P+Ti+C+O
forno: F+O+Rn+O
balão: Ba+La+O
belíssimo: Be+Li+S+Si+Mo
cereal: Ce+Re+Al
ingênuo: In+Ge+N+U+O
insucesso: In+S+U+C+Es+S+O
setenta: Se+Te+N+Ta
Chicago: C+H+I+C+Ag+O
cela: Ce+La
soprar: S+O+Pr+Ar
rap: Ra+P
fatura: F+At+U+Ra
espontâneo: Es+P+O+N+Ta+Ne+O
ternura: Te+Rn+U+Ra
politécnico: P+O+Li+Te+C+N+I+C+O
estética: Es+Te+Ti+Ca
monarca: Mo+N+Ar+Ca
filiar: F+I+Li+Ar
profeta: Pr+O+Fe+Ta
liceu: Li+C+Eu
brando: B+Ra+Nd+O
cheirar: C+He+Ir+Ar
conciliar: C+O+N+C+I+Li+Ar
solista: S+O+Li+S+Ta
chiar: C+H+I+Ar
sessenta: S+Es+Se+N+Ta
prescindir: P+Re+S+C+I+Nd+Ir
solucionar: S+O+Lu+C+I+O+N+Ar
resistente: Re+Si+S+Te+N+Te
periférico: P+Er+I+F+Er+I+C+O
heróico: H+Er+O+I+C+O
noticiário: N+O+Ti+C+I+Ar+I+O
interferir: In+Te+Rf+Er+Ir
lucrativo: Lu+C+Ra+Ti+V+O
véu: V+Eu
lacuna: La+C+U+Na
costeiro: C+O+S+Te+Ir+O
cavalheiro: Ca+V+Al+He+Ir+O
pico: P+I+C+O
suspirar: S+U+S+P+Ir+Ar
Hitler: H+I+Tl+Er
rechear: Re+C+He+Ar
cativar: C+At+I+V+Ar
clamar: Cl+Am+Ar
mote: Mo+Te
recriar: Re+Cr+I+Ar
crente: C+Re+N+Te
óptica: O+P+Ti+Ca
libanês: Li+Ba+N+Es
soberbo: S+O+Be+Rb+O
remover: Re+Mo+V+Er
fascismo: F+As+C+I+S+Mo
racional: Ra+C+I+O+N+Al
nau: N+Au
oitenta: O+I+Te+N+Ta
rapto: Ra+Pt+O
Hamas: H+Am+As
Carnaval: C+Ar+Na+V+Al
carvalho: C+Ar+V+Al+H+O
copiar: C+O+P+I+Ar
potente: P+O+Te+N+Te
alcoólico: Al+C+O+O+Li+C+O
vogal: V+Og+Al
beneficiário: Be+Ne+F+I+C+I+Ar+I+O
fibra: F+I+B+Ra
subúrbio: S+U+B+U+Rb+I+O
verbal: V+Er+B+Al
lapso: La+P+S+O
intensificar: In+Te+N+Si+F+I+C+Ar
sino: Si+N+O
sufrágio: S+U+Fr+Ag+I+O
artifício: Ar+Ti+F+I+C+I+O
genuíno: Ge+N+U+In+O
vigente: V+I+Ge+N+Te
verbo: V+Er+B+O
Ferreira: F+Er+Re+I+Ra
escandaloso: Es+Ca+Nd+Al+O+S+O
Ovar: O+V+Ar
Cannes: Ca+N+N+Es
incógnita: In+C+Og+N+I+Ta
notificar: N+O+Ti+F+I+C+Ar
lata: La+Ta
persistente: P+Er+Si+S+Te+N+Te
usufruir: U+S+U+F+Ru+Ir
recreio: Re+C+Re+I+O
sumo: S+U+Mo
acústico: Ac+U+S+Ti+C+O
of: O+F
ciclismo: C+I+C+Li+S+Mo
obrigacionista: O+Br+I+Ga+C+I+O+N+I+S+Ta
Inverno: In+V+Er+N+O
concessionário: C+O+N+C+Es+Si+O+N+Ar+I+O
privar: Pr+I+V+Ar
americana: Am+Er+I+Ca+Na
Chirac: C+H+I+Ra+C
pássaro: P+As+S+Ar+O
burguês: B+U+Rg+U+Es
Alcântara: Al+Ca+N+Ta+Ra
Fenprof: Fe+N+Pr+O+F
partícula: P+Ar+Ti+C+U+La
boi: B+O+I
consistente: C+O+N+Si+S+Te+N+Te
repouso: Re+P+O+U+S+O
espancar: Es+Pa+N+C+Ar
itinerário: I+Ti+N+Er+Ar+I+O
freira: F+Re+I+Ra
reparo: Re+P+Ar+O
Feira: Fe+I+Ra
largura: La+Rg+U+Ra
referenciar: Re+Fe+Re+N+C+I+Ar
monge: Mo+N+Ge
stand: S+Ta+Nd
non: N+O+N
esmola: Es+Mo+La
vocalista: V+O+C+Al+I+S+Ta
raciocínio: Ra+C+I+O+C+In+I+O
raptar: Ra+Pt+Ar
Praga: P+Ra+Ga
albufeira: Al+B+U+Fe+I+Ra
ouvinte: O+U+V+In+Te
operativo: O+P+Er+At+I+V+O
crónica: Cr+O+N+I+Ca
testa: Te+S+Ta
olival: O+Li+V+Al
bico: B+I+C+O
Rui: Ru+I
Mónaco: Mo+N+Ac+O
lusófono: Lu+S+O+F+O+N+O
vaso: V+As+O
parágrafo: P+Ar+Ag+Ra+F+O
renascer: Re+N+As+C+Er
naõ: Na+O
realismo: Re+Al+I+S+Mo
carbono: C+Ar+B+O+N+O
tabu: Ta+B+U
férreo: F+Er+Re+O
fascínio: F+As+C+In+I+O
ira: I+Ra
genial: Ge+N+I+Al
colina: C+O+Li+Na
física: F+I+Si+Ca
castanho: C+As+Ta+N+H+O
caseiro: Ca+Se+Ir+O
banal: Ba+N+Al
nervosismo: N+Er+V+O+Si+S+Mo
balneário: B+Al+Ne+Ar+I+O
pinheiro: P+In+He+Ir+O
repousar: Re+P+O+U+S+Ar
cerâmica: C+Er+Am+I+Ca
cooperativo: C+O+O+P+Er+At+I+V+O
boneco: B+O+Ne+C+O
Nuno: N+U+N+O
cupão: C+U+Pa+O
Singapura: Si+N+Ga+P+U+Ra
gala: Ga+La
presenciar: P+Re+Se+N+C+I+Ar
revogar: Re+V+Og+Ar
suspiro: S+U+S+P+Ir+O
fluvial: F+Lu+V+I+Al
seropositivo: S+Er+O+P+O+Si+Ti+V+O
oiro: O+Ir+O
caractere: C+Ar+Ac+Te+Re
alternar: Al+Te+Rn+Ar
recibo: Re+C+I+B+O
processual: Pr+O+C+Es+S+U+Al
Sec: Se+C
confesso: C+O+N+F+Es+S+O
terapêutico: Te+Ra+P+Eu+Ti+C+O
hipotético: H+I+P+O+Te+Ti+C+O
cru: C+Ru
Canal: Ca+N+Al
pá: Pa
replicar: Re+P+Li+C+Ar
Peres: P+Er+Es
hoste: H+O+S+Te
fascinante: F+As+C+I+Na+N+Te
reivindicativo: Re+I+V+I+Nd+I+C+At+I+V+O
si: Si
secar: Se+C+Ar
arrasar: Ar+Ra+S+Ar
Chipre: C+H+I+P+Re
filial: F+I+Li+Al
ninho: N+In+H+O
fascinar: F+As+C+In+Ar
indígena: I+Nd+I+Ge+Na
islão: I+S+La+O
táctica: Ta+C+Ti+Ca
populacional: P+O+P+U+La+C+I+O+N+Al
pinhal: P+In+H+Al
benéfico: Be+Ne+F+I+C+O
pirata: P+I+Ra+Ta
morno: Mo+Rn+O
cooperar: C+O+O+P+Er+Ar
fosso: F+O+S+S+O
tenso: Te+N+S+O
Filipinas: F+I+Li+P+In+As
escuta: Es+C+U+Ta
partes: P+Ar+Te+S
caótico: Ca+O+Ti+C+O
carinho: C+Ar+In+H+O
Peru: P+Er+U
falir: F+Al+Ir
vertical: V+Er+Ti+C+Al
Mota: Mo+Ta
profissionalismo: Pr+O+F+I+S+Si+O+N+Al+I+S+Mo
cõ: C+O
blues: B+Lu+Es
insinuar: In+Si+N+U+Ar
convincente: C+O+N+V+In+Ce+N+Te
fronteiro: Fr+O+N+Te+Ir+O
casta: C+As+Ta
fronte: Fr+O+N+Te
boxe: B+O+Xe
Albufeira: Al+B+U+Fe+I+Ra
cepticismo: Ce+P+Ti+C+I+S+Mo
poluir: P+O+Lu+Ir
fracassar: F+Ra+C+As+S+Ar
Frelimo: F+Re+Li+Mo
patamar: P+At+Am+Ar
viola: V+I+O+La
Este: Es+Te
César: C+Es+Ar
atar: At+Ar
sopro: S+O+Pr+O
preferencial: P+Re+Fe+Re+N+C+I+Al
chocante: C+H+O+Ca+N+Te
atmosférico: At+Mo+S+F+Er+I+C+O
politicar: P+O+Li+Ti+C+Ar
erótico: Er+O+Ti+C+O
crônica: Cr+O+N+I+Ca
racial: Ra+C+I+Al
clã: C+La
cênico: Ce+N+I+C+O
capricho: Ca+Pr+I+C+H+O
noivo: N+O+I+V+O
focar: F+O+C+Ar
unificar: U+N+I+F+I+C+Ar
fundir: F+U+Nd+Ir
coreógrafo: C+O+Re+Og+Ra+F+O
naufrágio: N+Au+Fr+Ag+I+O
Arsenal: Ar+Se+N+Al
vibrar: V+I+Br+Ar
arraial: Ar+Ra+I+Al
cascar: C+As+C+Ar
Francisco: F+Ra+N+C+I+S+C+O
flanco: F+La+N+C+O
frescura: F+Re+S+C+U+Ra
precoce: P+Re+C+O+Ce
caricatura: C+Ar+I+C+At+U+Ra
arsenal: Ar+Se+N+Al
festivo: F+Es+Ti+V+O
bovino: B+O+V+In+O
vincar: V+In+C+Ar
preparativo: P+Re+P+Ar+At+I+V+O
cúpula: C+U+P+U+La
clero: Cl+Er+O
ressalvar: Re+S+S+Al+V+Ar
auge: Au+Ge
contencioso: C+O+N+Te+N+C+I+O+S+O
Fretilin: F+Re+Ti+Li+N
pose: P+O+Se
rancho: Ra+N+C+H+O
camioneta: C+Am+I+O+Ne+Ta
Sony: S+O+N+Y
Moita: Mo+I+Ta
livreiro: Li+V+Re+Ir+O
revés: Re+V+Es
carenciar: Ca+Re+N+C+I+Ar
Beira: Be+I+Ra
luar: Lu+Ar
atalhar: At+Al+H+Ar
recta: Re+C+Ta
cantiga: Ca+N+Ti+Ga
Luís: Lu+I+S
Eusébio: Eu+Se+B+I+O
Basílio: B+As+I+Li+O
Óscar: O+S+C+Ar
incondicional: In+C+O+Nd+I+C+I+O+N+Al
calibre: C+Al+I+B+Re
sr: Sr
moinho: Mo+In+H+O
fúnebre: F+U+Ne+B+Re
sufocar: S+U+F+O+C+Ar
Senna: Se+N+Na
site: Si+Te
ra: Ra
cm: Cm
Tavira: Ta+V+I+Ra
boato: B+O+At+O
cravo: C+Ra+V+O
on: O+N
McLaren: Mc+La+Re+N
cravar: C+Ra+V+Ar
arrebatar: Ar+Re+B+At+Ar
Moura: Mo+U+Ra
Eriksson: Er+I+K+S+S+O+N
áspero: As+P+Er+O
peste: P+Es+Te
óptico: O+P+Ti+C+O
at: At
estai: Es+Ta+I
usual: U+S+U+Al
espesso: Es+P+Es+S+O
certificar: C+Er+Ti+F+I+C+Ar
camionista: C+Am+I+O+N+I+S+Ta
hipócrita: H+I+P+O+Cr+I+Ta
branca: B+Ra+N+Ca
sinônimo: Si+N+O+N+I+Mo
urânio: U+Ra+N+I+O
liberalismo: Li+Be+Ra+Li+S+Mo
cabra: Ca+B+Ra
rebanho: Re+Ba+N+H+O
Estaline: Es+Ta+Li+Ne
pérola: P+Er+O+La
fragata: F+Ra+Ga+Ta
futebolístico: F+U+Te+B+O+Li+S+Ti+C+O
vice: V+I+Ce
seringa: S+Er+In+Ga
alga: Al+Ga
prognóstico: Pr+Og+N+O+S+Ti+C+O
Algés: Al+Ge+S
flauta: F+La+U+Ta
cantina: Ca+N+Ti+Na
hindu: H+I+Nd+U
artes: Ar+Te+S
Vasco: V+As+C+O
suar: S+U+Ar
mosca: Mo+S+Ca
confiscar: C+O+N+F+I+S+C+Ar
Palestina: P+Al+Es+Ti+Na
paisagístico: Pa+I+S+Ag+I+S+Ti+C+O
capita: Ca+P+I+Ta
Amoreiras: Am+O+Re+I+Ra+S
Sampras: S+Am+P+Ra+S
soprano: S+O+P+Ra+N+O
praga: P+Ra+Ga
balnear: B+Al+Ne+Ar
alusivo: Al+U+Si+V+O
Como: C+O+Mo
ambicionar: Am+B+I+C+I+O+N+Ar
indicativo: I+Nd+I+C+At+I+V+O
Amaral: Am+Ar+Al
acatar: Ac+At+Ar
Hamburgo: H+Am+B+U+Rg+O
banhar: Ba+N+H+Ar
posicionar: P+O+Si+C+I+O+N+Ar
auferir: Au+F+Er+Ir
reprovar: Re+Pr+O+V+Ar
Narciso: N+Ar+C+I+S+O
tirano: Ti+Ra+N+O
sintético: Si+N+Te+Ti+C+O
Org: O+Rg
unionista: U+N+I+O+N+I+S+Ta
terno: Te+Rn+O
super: S+U+P+Er
revolver: Re+V+O+Lv+Er
confinar: C+O+N+F+In+Ar
reciclar: Re+C+I+Cl+Ar
besta: Be+S+Ta
britânica: Br+I+Ta+N+I+Ca
Vilamoura: V+I+La+Mo+U+Ra
parir: P+Ar+Ir
Blair: B+La+Ir
será: Se+Ra
sitiar: Si+Ti+Ar
Octávio: O+C+Ta+V+I+O
baralhar: B+Ar+Al+H+Ar
resgatar: Re+Sg+At+Ar
infernal: In+F+Er+N+Al
progressista: Pr+Og+Re+S+Si+S+Ta
pretenso: P+Re+Te+N+S+O
feitio: Fe+I+Ti+O
gay: Ga+Y
vilão: V+I+La+O
Iuran: I+U+Ra+N
insistente: In+Si+S+Te+N+Te
brusco: B+Ru+S+C+O
servo: S+Er+V+O
Nos: N+O+S
cativo: C+At+I+V+O
laser: La+S+Er
reviver: Re+V+I+V+Er
cabina: Ca+B+I+Na
bíblico: B+I+B+Li+C+O
eucalipto: Eu+C+Al+I+Pt+O
praxe: P+Ra+Xe
provincial: Pr+O+V+In+C+I+Al
assinante: As+Si+Na+N+Te
viúvo: V+I+U+V+O
fera: Fe+Ra
Esta: Es+Ta
prefácio: P+Re+F+Ac+I+O
cobre: C+O+B+Re
banir: Ba+N+Ir
Hebron: He+Br+O+N
liso: Li+S+O
cavar: Ca+V+Ar
Esopo: Es+O+P+O
brindar: Br+I+Nd+Ar
resgate: Re+S+Ga+Te
fauna: F+Au+Na
Alcochete: Al+C+O+C+He+Te
propiciar: Pr+O+P+I+C+I+Ar
soberana: S+O+Be+Ra+Na
rabo: Ra+B+O
asneira: As+Ne+I+Ra
ambulante: Am+B+U+La+N+Te
pluralismo: P+Lu+Ra+Li+S+Mo
suprir: S+U+Pr+Ir
Sagres: S+Ag+Re+S
pertinente: P+Er+Ti+Ne+N+Te
intensivo: In+Te+N+Si+V+O
comover: C+O+Mo+V+Er
sóbrio: S+O+Br+I+O
remo: Re+Mo
prover: Pr+O+V+Er
harmonioso: H+Ar+Mo+N+I+O+S+O
falsificar: F+Al+Si+F+I+C+Ar
champanhe: C+H+Am+Pa+N+He
Chelas: C+He+La+S
Paula: P+Au+La
promocional: Pr+O+Mo+C+I+O+N+Al
sobrevoar: S+O+B+Re+V+O+Ar
latente: La+Te+N+Te
cronista: Cr+O+N+I+S+Ta
chocolate: C+H+O+C+O+La+Te
ilibar: I+Li+B+Ar
oficioso: O+F+I+C+I+O+S+O
Sérgio: Se+Rg+I+O
Rey: Re+Y
surf: S+U+Rf
rústico: Ru+S+Ti+C+O
natalício: N+At+Al+I+C+I+O
invés: In+V+Es
cimo: C+I+Mo
balcânico: B+Al+Ca+N+I+C+O
fictício: F+I+C+Ti+C+I+O
aura: Au+Ra
filipino: F+I+Li+P+In+O
carismático: C+Ar+I+Sm+At+I+C+O
caricato: C+Ar+I+C+At+O
banana: Ba+Na+Na
superficial: S+U+P+Er+F+I+C+I+Al
populista: P+O+P+U+Li+S+Ta
condicionante: C+O+Nd+I+C+I+O+Na+N+Te
hemofílico: He+Mo+F+I+Li+C+O
gare: Ga+Re
frenético: F+Re+Ne+Ti+C+O
próspero: Pr+O+S+P+Er+O
patético: Pa+Te+Ti+C+O
linho: Li+N+H+O
taliban: Ta+Li+Ba+N
mota: Mo+Ta
rega: Re+Ga
Caraíbas: Ca+Ra+I+B+As
Cunhal: C+U+N+H+Al
laico: La+I+C+O
cabecear: Ca+Be+Ce+Ar
casco: C+As+C+O
baterista: B+At+Er+I+S+Ta
repressivo: Re+P+Re+S+Si+V+O
Ténis: Te+N+I+S
picar: P+I+C+Ar
ruir: Ru+Ir
centésimo: Ce+N+Te+Si+Mo
Beirute: Be+I+Ru+Te
influir: In+F+Lu+Ir
ratinho: Ra+Ti+N+H+O
gaio: Ga+I+O
recensear: Re+Ce+N+Se+Ar
votante: V+O+Ta+N+Te
cal: C+Al
tenente: Te+Ne+N+Te
blindar: B+Li+Nd+Ar
espiral: Es+P+Ir+Al
cano: Ca+N+O
Baker: Ba+K+Er
esposo: Es+P+O+S+O
raso: Ra+S+O
inibir: In+I+B+Ir
interativo: In+Te+Ra+Ti+V+O
rubricar: Ru+Br+I+C+Ar
cínico: C+In+I+C+O
secundar: Se+C+U+Nd+Ar
espessura: Es+P+Es+S+U+Ra
urgir: U+Rg+Ir
campa: C+Am+Pa
boné: B+O+Ne
linear: Li+Ne+Ar
hebraico: He+B+Ra+I+C+O
Serralves: S+Er+Ra+Lv+Es
op: O+P
Artes: Ar+Te+S
inflamar: In+Fl+Am+Ar
consubstanciar: C+O+N+S+U+B+S+Ta+N+C+I+Ar
assar: As+S+Ar
Picasso: P+I+C+As+S+O
receoso: Re+Ce+O+S+O
gabar: Ga+B+Ar
cana: Ca+Na
Ivic: I+V+I+C
seta: Se+Ta
crosse: Cr+O+S+Se
beligerante: Be+Li+Ge+Ra+N+Te
altivo: Al+Ti+V+O
intestino: In+Te+S+Ti+N+O
atlântico: At+La+N+Ti+C+O
conceptual: C+O+N+Ce+Pt+U+Al
Tavares: Ta+V+Ar+Es
náutico: N+Au+Ti+C+O
ocasional: O+C+As+I+O+N+Al
repto: Re+Pt+O
amparar: Am+P+Ar+Ar
sensato: Se+N+S+At+O
arca: Ar+Ca
cota: C+O+Ta
sinfônico: Si+N+F+O+N+I+C+O
rubro: Ru+Br+O
propagar: Pr+O+P+Ag+Ar
reatar: Re+At+Ar
vassalo: V+As+S+Al+O
Foi: F+O+I
recreativo: Re+C+Re+At+I+V+O
pioneira: P+I+O+Ne+I+Ra
oásis: O+As+I+S
Bach: B+Ac+H
palmo: P+Al+Mo
tecla: Te+C+La
sentenciar: Se+N+Te+N+C+I+Ar
arrefecer: Ar+Re+Fe+C+Er
cobra: C+O+B+Ra
Philips: P+H+I+Li+P+S
parvo: P+Ar+V+O
falcão: F+Al+Ca+O
policiar: P+O+Li+C+I+Ar
vinculativo: V+In+C+U+La+Ti+V+O
cv: C+V
Bruno: B+Ru+N+O
cântico: Ca+N+Ti+C+O
brio: Br+I+O
pílula: P+I+Lu+La
noites: N+O+I+Te+S
esticar: Es+Ti+C+Ar
volumoso: V+O+Lu+Mo+S+O
Nino: N+In+O
inofensivo: In+O+Fe+N+Si+V+O
Libération: Li+Be+Ra+Ti+O+N
fecundo: Fe+C+U+Nd+O
alta: Al+Ta
pata: Pa+Ta
circunscrever: C+Ir+C+U+N+S+C+Re+V+Er
Amaro: Am+Ar+O
caneta: Ca+Ne+Ta
obrar: O+Br+Ar
ferver: F+Er+V+Er
Aloísio: Al+O+I+Si+O
Social: S+O+C+I+Al
Baptista: Ba+P+Ti+S+Ta
ag: Ag
skipper: S+K+I+P+P+Er
forasteiro: F+O+Ra+S+Te+Ir+O
válvula: V+Al+V+U+La
un: U+N
rescindir: Re+S+C+I+Nd+Ir
báltico: B+Al+Ti+C+O
esférico: Es+F+Er+I+C+O
neoliberal: Ne+O+Li+B+Er+Al
taberna: Ta+B+Er+Na
pacato: P+Ac+At+O
hasta: H+As+Ta
arrepio: Ar+Re+P+I+O
oposicionista: O+P+O+Si+C+I+O+N+I+S+Ta
cinta: C+In+Ta
escavar: Es+Ca+V+Ar
sugestivo: S+U+Ge+S+Ti+V+O
feiticeiro: Fe+I+Ti+Ce+Ir+O
Tiago: Ti+Ag+O
baptismo: Ba+P+Ti+S+Mo
versar: V+Er+S+Ar
lucrar: Lu+Cr+Ar
alicerce: Al+I+C+Er+Ce
Fernandes: F+Er+Na+Nd+Es
coreográfico: C+O+Re+Og+Ra+F+I+C+O
condicional: C+O+Nd+I+C+I+O+N+Al
off: O+F+F
western: W+Es+Te+Rn
catolicismo: C+At+O+Li+C+I+S+Mo
carneiro: C+Ar+Ne+Ir+O
caiar: Ca+I+Ar
Burundi: B+U+Ru+Nd+I
sensual: Se+N+S+U+Al
custear: C+U+S+Te+Ar
Serpa: S+Er+Pa
balbuciar: B+Al+B+U+C+I+Ar
ás: As
confeccionar: C+O+N+Fe+C+C+I+O+N+Ar
cera: Ce+Ra
génese: Ge+Ne+Se
tenebroso: Te+Ne+Br+O+S+O
Assis: As+Si+S
Franco: F+Ra+N+C+O
chato: C+H+At+O
escalar: Es+C+Al+Ar
associativismo: As+S+O+C+I+At+I+V+I+S+Mo
punk: P+U+N+K
cabeceira: Ca+Be+Ce+I+Ra
sátira: S+At+I+Ra
esbater: Es+B+At+Er
ativar: At+I+V+Ar
nocivo: N+O+C+I+V+O
Cravinho: C+Ra+V+In+H+O
reacionário: Re+Ac+I+O+N+Ar+I+O
Óscares: O+S+C+Ar+Es
internar: In+Te+Rn+Ar
alho: Al+H+O
acervo: Ac+Er+V+O
espinho: Es+P+In+H+O
certeiro: C+Er+Te+Ir+O
receptivo: Re+Ce+P+Ti+V+O
prescrever: P+Re+S+C+Re+V+Er
pólvora: P+O+Lv+O+Ra
ressurgir: Re+S+S+U+Rg+Ir
almo: Al+Mo
rebater: Re+B+At+Er
pala: Pa+La
líbio: Li+B+I+O
Fiorentina: F+I+O+Re+N+Ti+Na
Oeste: O+Es+Te
florescer: Fl+O+Re+S+C+Er
obsessivo: O+B+S+Es+Si+V+O
chaminé: C+H+Am+I+Ne
Freitas: F+Re+I+Ta+S
calcanhar: C+Al+Ca+N+H+Ar
contabilístico: C+O+N+Ta+B+I+Li+S+Ti+C+O
proliferar: Pr+O+Li+F+Er+Ar
átomo: At+O+Mo
retificar: Re+Ti+F+I+C+Ar
Álvaro: Al+V+Ar+O
Nantes: Na+N+Te+S
viciar: V+I+C+I+Ar
incendiário: In+Ce+Nd+I+Ar+I+O
camarote: C+Am+Ar+O+Te
Chico: C+H+I+C+O
assobiar: As+S+O+B+I+Ar
rusga: Ru+S+Ga
crânio: C+Ra+N+I+O
eslavo: Es+La+V+O
realce: Re+Al+Ce
Cáucaso: C+Au+C+As+O
classificativo: C+La+S+Si+F+I+C+At+I+V+O
Neno: Ne+N+O
instantâneo: In+S+Ta+N+Ta+Ne+O
arruinar: Ar+Ru+In+Ar
violinista: V+I+O+Li+N+I+S+Ta
revolucionar: Re+V+O+Lu+C+I+O+N+Ar
Capucho: Ca+P+U+C+H+O
fundista: F+U+Nd+I+S+Ta
amo: Am+O
cinismo: C+In+I+S+Mo
recíproco: Re+C+I+Pr+O+C+O
Fiat: F+I+At
estilista: Es+Ti+Li+S+Ta
xenófobo: Xe+N+O+F+O+B+O
sondar: S+O+Nd+Ar
bife: B+I+Fe
re: Re
francófono: F+Ra+N+C+O+F+O+N+O
áureo: Au+Re+O
sic: Si+C
Timofte: Ti+Mo+F+Te
parco: P+Ar+C+O
Isso: I+S+S+O
aliciar: Al+I+C+I+Ar
tesoureiro: Te+S+O+U+Re+Ir+O
positivar: P+O+Si+Ti+V+Ar
Serra: S+Er+Ra
homogêneo: H+O+Mo+Ge+Ne+O
beco: Be+C+O
punhal: P+U+N+H+Al
boneca: B+O+Ne+Ca
barreirense: B+Ar+Re+I+Re+N+Se
pacificar: P+Ac+I+F+I+C+Ar
nicho: N+I+C+H+O
clarão: C+La+Ra+O
cebola: Ce+B+O+La
Cristina: Cr+I+S+Ti+Na
estante: Es+Ta+N+Te
cárcere: C+Ar+Ce+Re
Caparica: Ca+P+Ar+I+Ca
samba: S+Am+Ba
Nature: N+At+U+Re
arrendar: Ar+Re+Nd+Ar
nativo: N+At+I+V+O
Inês: In+Es
inflacionista: In+F+La+C+I+O+N+I+S+Ta
lápis: La+P+I+S
staff: S+Ta+F+F
rácio: Ra+C+I+O
Fonseca: F+O+N+Se+Ca
sucata: S+U+Ca+Ta
sacar: S+Ac+Ar
uno: U+N+O
ornar: O+Rn+Ar
infrutífero: In+F+Ru+Ti+F+Er+O
harmônico: H+Ar+Mo+N+I+C+O
condicionalismo: C+O+Nd+I+C+I+O+N+Al+I+S+Mo
chip: C+H+I+P
cf: C+F
coser: C+O+S+Er
concernir: C+O+N+C+Er+N+Ir
opinar: O+P+In+Ar
capote: Ca+P+O+Te
neta: Ne+Ta
rasteiro: Ra+S+Te+Ir+O
Lula: Lu+La
ícone: I+C+O+Ne
referendar: Re+Fe+Re+Nd+Ar
inerte: In+Er+Te
ónus: O+N+U+S
alucinante: Al+U+C+I+Na+N+Te
versus: V+Er+S+U+S
pato: P+At+O
supervisionar: S+U+P+Er+V+I+Si+O+N+Ar
secretismo: Se+C+Re+Ti+S+Mo
pornográfico: P+O+Rn+Og+Ra+F+I+C+O
frei: F+Re+I
ermo: Er+Mo
Spínola: S+P+In+O+La
sinuoso: Si+N+U+O+S+O
Internacional: In+Te+Rn+Ac+I+O+N+Al
Bicesse: B+I+C+Es+Se
coeso: C+O+Es+O
sobra: S+O+B+Ra
funerário: F+U+N+Er+Ar+I+O
carrasco: C+Ar+Ra+S+C+O
Alice: Al+I+Ce
Teixeira: Te+I+Xe+I+Ra
caverna: Ca+V+Er+Na
bengala: Be+N+Ga+La
cobro: C+O+Br+O
escamotear: Es+C+Am+O+Te+Ar
cabine: Ca+B+I+Ne
Inácio: In+Ac+I+O
Vicente: V+I+Ce+N+Te
lacônico: La+C+O+N+I+C+O
Flores: Fl+O+Re+S
auspício: Au+S+P+I+C+I+O
reinante: Re+I+Na+N+Te
pasmar: Pa+Sm+Ar
lapa: La+Pa
Berta: B+Er+Ta
Warner: W+Ar+N+Er
lavoura: La+V+O+U+Ra
terapêutica: Te+Ra+P+Eu+Ti+Ca
itinerante: I+Ti+Ne+Ra+N+Te
escarlate: Es+C+Ar+La+Te
estafeta: Es+Ta+Fe+Ta
esmorecer: Es+Mo+Re+C+Er
poisar: P+O+I+S+Ar
Laura: La+U+Ra
Sócrates: S+O+C+Ra+Te+S
casca: C+As+Ca
Sicasal: Si+C+As+Al
frasco: F+Ra+S+C+O
asseverar: As+Se+V+Er+Ar
you: Y+O+U
Wagner: W+Ag+N+Er
rasca: Ra+S+Ca
fM: Fm
feirante: Fe+I+Ra+N+Te
escoar: Es+C+O+Ar
Banif: Ba+N+I+F
estereótipo: Es+Te+Re+O+Ti+P+O
obcecar: O+B+Ce+C+Ar
escassear: Es+C+As+Se+Ar
Carolina: C+Ar+O+Li+Na
Agustina: Ag+U+S+Ti+Na
Tirana: Ti+Ra+Na
al: Al
estaca: Es+Ta+Ca
bonificar: B+O+N+I+F+I+C+Ar
suite: S+U+I+Te
Virgílio: V+I+Rg+I+Li+O
paterno: P+At+Er+N+O
Lusoponte: Lu+S+O+P+O+N+Te
atracar: At+Ra+C+Ar
Souselas: S+O+U+Se+La+S
score: S+C+O+Re
patentear: Pa+Te+N+Te+Ar
irracional: Ir+Ra+C+I+O+N+Al
parabólico: Pa+Ra+B+O+Li+C+O
chacina: C+H+Ac+I+Na
aluna: Al+U+Na
recruta: Re+C+Ru+Ta
panela: Pa+Ne+La
tira: Ti+Ra
Srebrenica: S+Re+B+Re+N+I+Ca
onipresente: O+N+I+P+Re+Se+N+Te
estático: Es+Ta+Ti+C+O
recarga: Re+C+Ar+Ga
Agassi: Ag+As+Si
reconciliar: Re+C+O+N+C+I+Li+Ar
Moisés: Mo+I+S+Es
cratera: C+Ra+Te+Ra
atrapalhar: At+Ra+P+Al+H+Ar
Sp: S+P
sonante: S+O+Na+N+Te
gaffe: Ga+F+Fe
flora: Fl+O+Ra
alcoolismo: Al+C+O+O+Li+S+Mo
tailandês: Ta+I+La+Nd+Es
cunhal: C+U+N+H+Al
corno: C+O+Rn+O
carioca: C+Ar+I+O+Ca
Sobre: S+O+B+Re
assobio: As+S+O+B+I+O
resvalar: Re+S+V+Al+Ar
nos: N+O+S
bula: B+U+La
Herculano: H+Er+C+U+La+N+O
Bayern: Ba+Y+Er+N
pagão: Pa+Ga+O
Canárias: Ca+N+Ar+I+As
Ramos: Ra+Mo+S
montanhoso: Mo+N+Ta+N+H+O+S+O
escurecer: Es+C+U+Re+C+Er
Shamir: S+H+Am+Ir
palacete: Pa+La+Ce+Te
infecioso: In+Fe+C+I+O+S+O
obsceno: O+B+S+Ce+N+O
Horácio: H+O+Ra+C+I+O
barca: B+Ar+Ca
biográfico: B+I+Og+Ra+F+I+C+O
pontificar: P+O+N+Ti+F+I+C+Ar
galante: Ga+La+N+Te
Hussein: H+U+S+Se+In
vagar: V+Ag+Ar
serrano: S+Er+Ra+N+O
Neves: Ne+V+Es
bélico: Be+Li+C+O
sarraceno: S+Ar+Ra+Ce+N+O
Berna: B+Er+Na
cristalino: Cr+I+S+Ta+Li+N+O
vibrante: V+I+B+Ra+N+Te
reverso: Re+V+Er+S+O
camuflar: C+Am+U+Fl+Ar
voga: V+O+Ga
cósmico: C+O+Sm+I+C+O
férias: F+Er+I+As
alferes: Al+F+Er+Es
papagaio: Pa+Pa+Ga+I+O
fratura: Fr+At+U+Ra
franciscano: F+Ra+N+C+I+S+Ca+N+O
carnaval: C+Ar+Na+V+Al
Pp: P+P
Borges: B+O+Rg+Es
vicioso: V+I+C+I+O+S+O
prega: P+Re+Ga
sindicalismo: Si+Nd+I+C+Al+I+S+Mo
Moreira: Mo+Re+I+Ra
lareira: La+Re+I+Ra
benesse: Be+N+Es+Se
creche: C+Re+C+He
cavaco: Ca+V+Ac+O
indagar: I+Nd+Ag+Ar
alli: Al+Li
Palermo: P+Al+Er+Mo
conclusivo: C+O+N+C+Lu+Si+V+O
homônimo: H+O+Mo+N+I+Mo
incisivo: In+C+I+Si+V+O
sampaísta: S+Am+Pa+I+S+Ta
pay: Pa+Y
Carvalho: C+Ar+V+Al+H+O
acampar: Ac+Am+P+Ar
professar: Pr+O+F+Es+S+Ar
cuspir: C+U+S+P+Ir
recheio: Re+C+He+I+O
cifra: C+I+F+Ra
irrealista: Ir+Re+Al+I+S+Ta
revólver: Re+V+O+Lv+Er
veste: V+Es+Te
Tibete: Ti+Be+Te
Silvino: Si+Lv+In+O
cascata: C+As+Ca+Ta
Becker: Be+C+K+Er
sobrecarga: S+O+B+Re+C+Ar+Ga
Nunca: N+U+N+Ca
costela: C+O+S+Te+La
ingestão: In+Ge+S+Ta+O
Clara: C+La+Ra
vírgula: V+I+Rg+U+La
crucificar: C+Ru+C+I+F+I+C+Ar
bovinos: B+O+V+In+O+S
kitsch: K+I+Ts+C+H
Hitchcock: H+I+Tc+H+C+O+C+K
brochura: Br+O+C+H+U+Ra
fossar: F+O+S+S+Ar
coibir: C+O+I+B+Ir
sonata: S+O+Na+Ta
cerne: C+Er+Ne
ofuscar: O+F+U+S+C+Ar
sísmico: Si+Sm+I+C+O
visionário: V+I+Si+O+N+Ar+I+O
pacifista: P+Ac+I+F+I+S+Ta
censo: Ce+N+S+O
Camarões: C+Am+Ar+O+Es
banhista: Ba+N+H+I+S+Ta
spa: S+Pa
hu: H+U
fogão: F+O+Ga+O
fluir: F+Lu+Ir
monta: Mo+N+Ta
cifrar: C+I+Fr+Ar
fero: F+Er+O
Unicer: U+N+I+C+Er
pontífice: P+O+N+Ti+F+I+Ce
personificar: P+Er+S+O+N+I+F+I+C+Ar
Renato: Re+N+At+O
lunar: Lu+N+Ar
Sun: S+U+N
Silves: Si+Lv+Es
naufragar: N+Au+Fr+Ag+Ar
Bihac: B+I+H+Ac
reativar: Re+At+I+V+Ar
pipa: P+I+Pa
escandinavo: Es+Ca+Nd+I+Na+V+O
cunho: C+U+N+H+O
Bucareste: B+U+C+Ar+Es+Te
boy: B+O+Y
serenar: Se+Re+N+Ar
sensacional: Se+N+S+Ac+I+O+N+Al
papal: Pa+P+Al
moralista: Mo+Ra+Li+S+Ta
harpa: H+Ar+Pa
Nunes: N+U+N+Es
errante: Er+Ra+N+Te
Cabral: Ca+Br+Al
Lis: Li+S
farrapo: F+Ar+Ra+P+O
carpinteiro: C+Ar+P+In+Te+Ir+O
feixe: Fe+I+Xe
escravatura: Es+C+Ra+V+At+U+Ra
barbeiro: B+Ar+Be+Ir+O
clarinete: Cl+Ar+I+Ne+Te
cipriota: C+I+Pr+I+O+Ta
esteira: Es+Te+I+Ra
arrepiar: Ar+Re+P+I+Ar
acolá: Ac+O+La
Insp: In+S+P
estival: Es+Ti+V+Al
subversivo: S+U+B+V+Er+Si+V+O
substantivo: S+U+B+S+Ta+N+Ti+V+O
Barrancos: B+Ar+Ra+N+C+O+S
teimoso: Te+I+Mo+S+O
ósseo: O+S+Se+O
Berger: Be+Rg+Er
hipóteses: H+I+P+O+Te+S+Es
Repúblico: Re+P+U+B+Li+C+O
gênio: Ge+N+I+O
parasita: P+Ar+As+I+Ta
arcaico: Ar+Ca+I+C+O
inferir: In+F+Er+Ir
indisciplina: I+Nd+I+S+C+I+P+Li+Na
escuteiro: Es+C+U+Te+Ir+O
suborno: S+U+B+O+Rn+O
hesitante: H+Es+I+Ta+N+Te
cantão: Ca+N+Ta+O
vigésimo: V+I+Ge+Si+Mo
burgo: B+U+Rg+O
Thatcher: Th+At+C+H+Er
Smith: Sm+I+Th
reyno: Re+Y+N+O
Pacífico: P+Ac+I+F+I+C+O
Schengen: S+C+He+N+Ge+N
briga: Br+I+Ga
renal: Re+N+Al
Rabat: Ra+B+At
amora: Am+O+Ra
provérbio: Pr+O+V+Er+B+I+O
generalista: Ge+N+Er+Al+I+S+Ta
bónus: B+O+N+U+S
pio: P+I+O
Assi: As+Si
furacão: F+U+Ra+Ca+O
pungente: P+U+N+Ge+N+Te
cabal: Ca+B+Al
rasgo: Ra+Sg+O
charco: C+H+Ar+C+O
alhear: Al+He+Ar
cosmopolita: C+O+S+Mo+P+O+Li+Ta
copa: C+O+Pa
Carmo: C+Ar+Mo
ficcional: F+I+C+C+I+O+N+Al
cerâmico: C+Er+Am+I+C+O
brioso: Br+I+O+S+O
whisky: W+H+I+S+K+Y
prece: P+Re+Ce
pluralista: P+Lu+Ra+Li+S+Ta
Paneira: Pa+Ne+I+Ra
Flandres: F+La+Nd+Re+S
conferencista: C+O+N+Fe+Re+N+C+I+S+Ta
pauta: P+Au+Ta
Lacão: La+Ca+O
inchar: In+C+H+Ar
cabana: Ca+Ba+Na
soberba: S+O+B+Er+Ba
polvo: P+O+Lv+O
fiasco: F+I+As+C+O
concessionar: C+O+N+C+Es+Si+O+N+Ar
vértice: V+Er+Ti+Ce
caloiro: C+Al+O+Ir+O
referencial: Re+Fe+Re+N+C+I+Al
estandarte: Es+Ta+Nd+Ar+Te
vintena: V+In+Te+Na
Interfina: In+Te+Rf+I+Na
surfista: S+U+Rf+I+S+Ta
hiper: H+I+P+Er
carinhoso: C+Ar+In+H+O+S+O
privativo: Pr+I+V+At+I+V+O
be: Be
refrescar: Re+F+Re+S+C+Ar
sensacionalista: Se+N+S+Ac+I+O+N+Al+I+S+Ta
beato: Be+At+O
reinício: Re+In+I+C+I+O
mola: Mo+La
Lakers: La+K+Er+S
alcatrão: Al+C+At+Ra+O
sulista: S+U+Li+S+Ta
ruga: Ru+Ga
insurgir: In+S+U+Rg+Ir
assírio: As+S+Ir+I+O
piscar: P+I+S+C+Ar
picante: P+I+Ca+N+Te
prosperar: Pr+O+S+P+Er+Ar
cubo: C+U+B+O
funk: F+U+N+K
concílio: C+O+N+C+I+Li+O
Pontapés: P+O+N+Ta+P+Es
acarinhar: Ac+Ar+In+H+Ar
náufrago: N+Au+Fr+Ag+O
cismar: C+I+Sm+Ar
Bossi: B+O+S+Si
agreste: Ag+Re+S+Te
Vagos: V+Ag+O+S
utensílio: U+Te+N+Si+Li+O
suíno: S+U+In+O
brinco: Br+In+C+O
vaticinar: V+At+I+C+In+Ar
heroísmo: H+Er+O+I+S+Mo
cinegético: C+I+Ne+Ge+Ti+C+O
outeiro: O+U+Te+Ir+O
amaro: Am+Ar+O
Alatas: Al+At+As
sinagoga: Si+N+Ag+O+Ga
papá: Pa+Pa
repúblico: Re+P+U+B+Li+C+O
Simões: Si+Mo+Es
supérfluo: S+U+P+Er+F+Lu+O
nuca: N+U+Ca
Nice: N+I+Ce
moer: Mo+Er
Alves: Al+V+Es
Tenerife: Te+N+Er+I+Fe
taco: Ta+C+O
hispânico: H+I+S+Pa+N+I+C+O
tacho: Ta+C+H+O
moscovita: Mo+S+C+O+V+I+Ta
cear: Ce+Ar
Souness: S+O+U+N+Es+S
porão: P+O+Ra+O
Física: F+I+Si+Ca
narciso: N+Ar+C+I+S+O
Viriato: V+Ir+I+At+O
saloio: S+Al+O+I+O
Gaspar: Ga+S+P+Ar
ré: Re
ópio: O+P+I+O
inovar: In+O+V+Ar
rã: Ra
Knicks: K+N+I+C+K+S
Kasparov: K+As+P+Ar+O+V
inconclusivo: In+C+O+N+C+Lu+Si+V+O
alagar: Al+Ag+Ar
proteccionismo: Pr+O+Te+C+C+I+O+N+I+S+Mo
naturalista: N+At+U+Ra+Li+S+Ta
Atlantis: At+La+N+Ti+S
aresta: Ar+Es+Ta
campus: C+Am+P+U+S
volvo: V+O+Lv+O
intencional: In+Te+N+C+I+O+N+Al
circundar: C+Ir+C+U+Nd+Ar
Alpes: Al+P+Es
Coruche: C+O+Ru+C+He
uníssono: U+N+I+S+S+O+N+O
hipotecar: H+I+P+O+Te+C+Ar
Constâncio: C+O+N+S+Ta+N+C+I+O
cálice: C+Al+I+Ce
estilístico: Es+Ti+Li+S+Ti+C+O
Albertina: Al+B+Er+Ti+Na
tática: Ta+Ti+Ca
cíclico: C+I+C+Li+C+O
hastear: H+As+Te+Ar
cola: C+O+La
refrão: Re+F+Ra+O
campismo: C+Am+P+I+S+Mo
lindíssimo: Li+Nd+I+S+Si+Mo
inteirar: In+Te+Ir+Ar
crescendo: C+Re+S+Ce+Nd+O
mochila: Mo+C+H+I+La
capucho: Ca+P+U+C+H+O
bibliográfico: B+I+B+Li+Og+Ra+F+I+C+O
batuta: B+At+U+Ta
rebocar: Re+B+O+C+Ar
tecnocrata: Te+C+N+O+C+Ra+Ta
paternal: P+At+Er+N+Al
gentio: Ge+N+Ti+O
fraterno: F+Ra+Te+Rn+O
Branco: B+Ra+N+C+O
amore: Am+O+Re
acossar: Ac+O+S+S+Ar
tibetano: Ti+Be+Ta+N+O
secreta: Se+C+Re+Ta
Senhora: Se+N+H+O+Ra
ganga: Ga+N+Ga
caprichoso: Ca+Pr+I+C+H+O+S+O
parentesco: Pa+Re+N+Te+S+C+O
barracão: B+Ar+Ra+Ca+O
rente: Re+N+Te
obus: O+B+U+S
nao: Na+O
inflacionar: In+F+La+C+I+O+N+Ar
rabi: Ra+B+I
insensato: In+Se+N+S+At+O
espiar: Es+P+I+Ar
sobranceiro: S+O+B+Ra+N+Ce+Ir+O
gaivota: Ga+I+V+O+Ta
convés: C+O+N+V+Es
pântano: Pa+N+Ta+N+O
hebreu: He+B+Re+U
cápsula: Ca+P+S+U+La
bastão: B+As+Ta+O
refinar: Re+F+In+Ar
núncio: N+U+N+C+I+O
catalogar: C+At+Al+Og+Ar
salina: S+Al+I+Na
Gana: Ga+Na
bote: B+O+Te
civismo: C+I+V+I+S+Mo
Tivoli: Ti+V+O+Li
Catarina: C+At+Ar+I+Na
súplica: S+U+P+Li+Ca
conferenciar: C+O+N+Fe+Re+N+C+I+Ar
suplicar: S+U+P+Li+C+Ar
refrear: Re+F+Re+Ar
nata: Na+Ta
barrete: B+Ar+Re+Te
prenunciar: P+Re+N+U+N+C+I+Ar
popa: P+O+Pa
parábola: Pa+Ra+B+O+La
Titanic: Ti+Ta+N+I+C
protecionista: Pr+O+Te+C+I+O+N+I+S+Ta
Sinatra: Si+N+At+Ra
erário: Er+Ar+I+O
silvar: Si+Lv+Ar
conspirar: C+O+N+S+P+Ir+Ar
nafta: Na+F+Ta
Filipovic: F+I+Li+P+O+V+I+C
ateu: At+Eu
Coppola: C+O+P+P+O+La
Saturno: S+At+U+Rn+O
perpassar: P+Er+P+As+S+Ar
moreno: Mo+Re+N+O
cowboy: C+O+W+B+O+Y
brandir: B+Ra+Nd+Ir
sam: S+Am
clichê: C+Li+C+He
renhir: Re+N+H+Ir
pernicioso: P+Er+N+I+C+I+O+S+O
cravinho: C+Ra+V+In+H+O
cânone: Ca+N+O+Ne
novíssimo: N+O+V+I+S+Si+Mo
inócuo: In+O+C+U+O
aguar: Ag+U+Ar
rateio: Ra+Te+I+O
Índice: I+Nd+I+Ce
gaiola: Ga+I+O+La
canceroso: Ca+N+C+Er+O+S+O
Porfírio: P+O+Rf+Ir+I+O
Alesi: Al+Es+I
suplício: S+U+P+Li+C+I+O
satírico: S+At+Ir+I+C+O
sunita: S+U+N+I+Ta
acariciar: Ac+Ar+I+C+I+Ar
pró: Pr+O
Colares: C+O+La+Re+S
soer: S+O+Er
Reis: Re+I+S
Gestão: Ge+S+Ta+O
prenúncio: P+Re+N+U+N+C+I+O
obviar: O+B+V+I+Ar
Falcão: F+Al+Ca+O
agraciar: Ag+Ra+C+I+Ar
vacinar: V+Ac+In+Ar
Rei: Re+I
pasmo: P+As+Mo
Eugénio: Eu+Ge+N+I+O
Subaru: S+U+B+Ar+U
soco: S+O+C+O
brandura: B+Ra+Nd+U+Ra
rapina: Ra+P+I+Na
erotismo: Er+O+Ti+S+Mo
Balakov: Ba+La+K+O+V
pós: P+O+S
psicanálise: P+Si+Ca+N+Al+I+Se
Sofin: S+O+F+In
renitente: Re+N+I+Te+N+Te
interactivo: In+Te+Ra+C+Ti+V+O
cosmonauta: C+O+S+Mo+N+Au+Ta
refrigerante: Re+Fr+I+Ge+Ra+N+Te
oneroso: O+N+Er+O+S+O
house: H+O+U+Se
galão: Ga+La+O
foice: F+O+I+Ce
oficiar: O+F+I+C+I+Ar
sílaba: Si+La+Ba
vitalício: V+I+Ta+Li+C+I+O
ocioso: O+C+I+O+S+O
Prince: Pr+In+Ce
calcário: C+Al+C+Ar+I+O
Arouca: Ar+O+U+Ca
agravo: Ag+Ra+V+O
obreiro: O+B+Re+Ir+O
sobreiro: S+O+B+Re+Ir+O
amassar: Am+As+S+Ar
ressoar: Re+S+S+O+Ar
Real: Re+Al
precipício: P+Re+C+I+P+I+C+I+O
Paulinho: P+Au+Li+N+H+O
chassi: C+H+As+Si
sobrevir: S+O+B+Re+V+Ir
pub: P+U+B
cenoura: Ce+N+O+U+Ra
beliscar: Be+Li+S+C+Ar
paulista: P+Au+Li+S+Ta
Papa: Pa+Pa
finar: F+In+Ar
operático: O+P+Er+At+I+C+O
cisne: C+I+S+Ne
arrastão: Ar+Ra+S+Ta+O
Vialonga: V+I+Al+O+N+Ga
sótão: S+O+Ta+O
sesta: S+Es+Ta
Reyno: Re+Y+N+O
passarinho: P+As+S+Ar+In+H+O
Constantino: C+O+N+S+Ta+N+Ti+N+O
escarnecer: Es+C+Ar+Ne+C+Er
Bino: B+In+O
agasalhar: Ag+As+Al+H+Ar
fermoso: F+Er+Mo+S+O
bus: B+U+S
Balacov: B+Al+Ac+O+V
regatear: Re+Ga+Te+Ar
bagageira: Ba+Ga+Ge+I+Ra
américa: Am+Er+I+Ca
próstata: Pr+O+S+Ta+Ta
papar: Pa+P+Ar
olá: O+La
Brown: Br+O+W+N
amparo: Am+P+Ar+O
reescrever: Re+Es+C+Re+V+Er
Camberra: C+Am+B+Er+Ra
candura: Ca+Nd+U+Ra
Indurain: I+Nd+U+Ra+In
Ulisses: U+Li+S+S+Es
pluvial: P+Lu+V+I+Al
álibi: Al+I+B+I
carteiro: C+Ar+Te+Ir+O
sentinela: Se+N+Ti+Ne+La
sarar: S+Ar+Ar
incenso: In+Ce+N+S+O
Teseu: Te+S+Eu
Bocage: B+O+Ca+Ge
Amares: Am+Ar+Es
profético: Pr+O+Fe+Ti+C+O
Kigali: K+I+Ga+Li
congestionar: C+O+N+Ge+S+Ti+O+N+Ar
checa: C+He+Ca
Carla: C+Ar+La
tesoura: Te+S+O+U+Ra
sirene: Si+Re+Ne
presentear: P+Re+Se+N+Te+Ar
carnavalesco: C+Ar+Na+V+Al+Es+C+O
presépio: P+Re+Se+P+I+O
estancar: Es+Ta+N+C+Ar
taõ: Ta+O
Karoglan: K+Ar+Og+La+N
colunista: C+O+Lu+N+I+S+Ta
Báltico: B+Al+Ti+C+O
aspirante: As+P+I+Ra+N+Te
salpicar: S+Al+P+I+C+Ar
new: Ne+W
bunker: B+U+N+K+Er
SuperSonics: S+U+P+Er+S+O+N+I+C+S
pág: P+Ag
Esp: Es+P
Che: C+He
soalho: S+O+Al+H+O
reticente: Re+Ti+Ce+N+Te
planificar: P+La+N+I+F+I+C+Ar
tasca: Ta+S+Ca
hp: H+P
filão: F+I+La+O
farpa: F+Ar+Pa
sueste: S+U+Es+Te
Ericeira: Er+I+Ce+I+Ra
baluarte: B+Al+U+Ar+Te
sina: Si+Na
Isaltino: I+S+Al+Ti+N+O
careca: Ca+Re+Ca
vitela: V+I+Te+La
irreal: Ir+Re+Al
hipoteca: H+I+P+O+Te+Ca
geopolítico: Ge+O+P+O+Li+Ti+C+O
Chopin: C+H+O+P+In
pregão: P+Re+Ga+O
regente: Re+Ge+N+Te
sarcasmo: S+Ar+C+As+Mo
Cohen: C+O+He+N
artífice: Ar+Ti+F+I+Ce
bei: Be+I
agostinho: Ag+O+S+Ti+N+H+O
referendário: Re+Fe+Re+Nd+Ar+I+O
raiar: Ra+I+Ar
ocasionar: O+C+As+I+O+N+Ar
cioso: C+I+O+S+O
er: Er
visionar: V+I+Si+O+N+Ar
sogra: S+Og+Ra
Sam: S+Am
pa: Pa
bio: B+I+O
Ars: Ar+S
pataca: Pa+Ta+Ca
obeso: O+Be+S+O
fr: Fr
reiniciar: Re+In+I+C+I+Ar
coca: C+O+Ca
Agora: Ag+O+Ra
populismo: P+O+P+U+Li+S+Mo
hegemônico: He+Ge+Mo+N+I+C+O
fissura: F+I+S+S+U+Ra
cerimonial: C+Er+I+Mo+N+I+Al
oco: O+C+O
espinhoso: Es+P+In+H+O+S+O
biógrafo: B+I+Og+Ra+F+O
prótese: Pr+O+Te+Se
Ivkovic: I+V+K+O+V+I+C
calcar: C+Al+C+Ar
rachar: Ra+C+H+Ar
vampiro: V+Am+P+Ir+O
rai: Ra+I
famalicense: F+Am+Al+I+Ce+N+Se
Al: Al
Platão: P+La+Ta+O
Nairobi: Na+Ir+O+B+I
canela: Ca+Ne+La
Inapa: I+Na+Pa
techno: Te+C+H+N+O
catecismo: Ca+Te+C+I+S+Mo
baú: B+Au
garante: Ga+Ra+N+Te
Pristina: Pr+I+S+Ti+Na
sui: S+U+I
pára: Pa+Ra
percussionista: P+Er+C+U+S+Si+O+N+I+S+Ta
participativo: P+Ar+Ti+C+I+P+At+I+V+O
banheira: Ba+N+He+I+Ra
serão: Se+Ra+O
lacrimogéneo: La+Cr+I+Mo+Ge+Ne+O
chicote: C+H+I+C+O+Te
Baucau: B+Au+C+Au
posar: P+O+S+Ar
nora: N+O+Ra
feirense: Fe+I+Re+N+Se
paga: Pa+Ga
oval: O+V+Al
caixeiro: Ca+I+Xe+Ir+O
Alcanena: Al+Ca+Ne+Na
puta: P+U+Ta
nicotina: N+I+C+O+Ti+Na
Candal: Ca+Nd+Al
Nacional: N+Ac+I+O+N+Al
beirão: Be+I+Ra+O
subalterno: S+U+B+Al+Te+Rn+O
prognosticar: Pr+Og+N+O+S+Ti+C+Ar
posta: P+O+S+Ta
carnificina: C+Ar+N+I+F+I+C+I+Na
psicanalista: P+Si+Ca+N+Al+I+S+Ta
Gerês: Ge+Re+S
Cruyff: C+Ru+Y+F+F
cos: C+O+S
Beiras: Be+I+Ra+S
esticão: Es+Ti+Ca+O
Soure: S+O+U+Re
Recer: Re+C+Er
Crónica: Cr+O+N+I+Ca
Corão: C+O+Ra+O
rapper: Ra+P+P+Er
opaco: O+P+Ac+O
cêntimo: Ce+N+Ti+Mo
réis: Re+I+S
Genscher: Ge+N+S+C+H+Er
renascentista: Re+N+As+Ce+N+Ti+S+Ta
cenógrafo: Ce+N+Og+Ra+F+O
band: Ba+Nd
ruivo: Ru+I+V+O
Fra: F+Ra
propalar: Pr+O+P+Al+Ar
intestinal: In+Te+S+Ti+N+Al
chatice: C+H+At+I+Ce
calvário: C+Al+V+Ar+I+O
esfriar: Es+Fr+I+Ar
chuvoso: C+H+U+V+O+S+O
castanheiro: C+As+Ta+N+He+Ir+O
artefato: Ar+Te+F+At+O
relance: Re+La+N+Ce
Campos: C+Am+P+O+S
arcar: Ar+C+Ar
timoneiro: Ti+Mo+Ne+Ir+O
Reno: Re+N+O
Pescas: P+Es+C+As
punitivo: P+U+N+I+Ti+V+O
proverbial: Pr+O+V+Er+B+I+Al
Morais: Mo+Ra+I+S
herege: He+Re+Ge
botica: B+O+Ti+Ca
secessionista: Se+C+Es+Si+O+N+I+S+Ta
lacaio: La+Ca+I+O
cancerígeno: Ca+N+C+Er+I+Ge+N+O
articulista: Ar+Ti+C+U+Li+S+Ta
aligeirar: Al+I+Ge+Ir+Ar
hepatite: He+P+At+I+Te
récita: Re+C+I+Ta
Inag: In+Ag
pinho: P+In+H+O
onírico: O+N+Ir+I+C+O
canônico: Ca+N+O+N+I+C+O
Buraca: B+U+Ra+Ca
bica: B+I+Ca
Arte: Ar+Te
vácuo: V+Ac+U+O
sertão: S+Er+Ta+O
escalonar: Es+C+Al+O+N+Ar
ers: Er+S
ostensivo: O+S+Te+N+Si+V+O
estacar: Es+Ta+C+Ar
Tbilissi: Tb+I+Li+S+Si
classicismo: C+La+S+Si+C+I+S+Mo
casual: C+As+U+Al
Panduru: Pa+Nd+U+Ru
Suns: S+U+N+S
cosmos: C+O+S+Mo+S
asno: As+N+O
vinagre: V+In+Ag+Re
cancioneiro: Ca+N+C+I+O+Ne+Ir+O
brancura: B+Ra+N+C+U+Ra
ruinoso: Ru+In+O+S+O
rebate: Re+Ba+Te
profundar: Pr+O+F+U+Nd+Ar
conducente: C+O+Nd+U+Ce+N+Te
Sina: Si+Na
canteiro: Ca+N+Te+Ir+O
sola: S+O+La
palavrão: Pa+La+V+Ra+O
ni: N+I
boîte: B+O+I+Te
viral: V+Ir+Al
Ruy: Ru+Y
cocheiro: C+O+C+He+Ir+O
Beirolas: Be+Ir+O+La+S
Vouga: V+O+U+Ga
Cinearte: C+I+Ne+Ar+Te
carapau: Ca+Ra+P+Au
neoliberalismo: Ne+O+Li+Be+Ra+Li+S+Mo
líbero: Li+B+Er+O
Inesc: In+Es+C
luneta: Lu+Ne+Ta
Ceuta: C+Eu+Ta
cancela: Ca+N+Ce+La
Spa: S+Pa
Panathinaikos: Pa+N+At+H+I+Na+I+K+O+S
escárnio: Es+C+Ar+N+I+O
proscrever: Pr+O+S+C+Re+V+Er
espreita: Es+P+Re+I+Ta
assessora: As+S+Es+S+O+Ra
Lucas: Lu+C+As
instintivo: In+S+Ti+N+Ti+V+O
Unicef: U+N+I+Ce+F
supranacional: S+U+P+Ra+N+Ac+I+O+N+Al
proponente: Pr+O+P+O+Ne+N+Te
Papandreou: Pa+Pa+Nd+Re+O+U
auspicioso: Au+S+P+I+C+I+O+S+O
Vip: V+I+P
Latapy: La+Ta+P+Y
espoliar: Es+P+O+Li+Ar
cáustico: C+Au+S+Ti+C+O
cacho: C+Ac+H+O
bravura: B+Ra+V+U+Ra
separatismo: Se+P+Ar+At+I+S+Mo
estalinista: Es+Ta+Li+N+I+S+Ta
Esse: Es+Se
coche: C+O+C+He
vagaroso: V+Ag+Ar+O+S+O
by: B+Y
aly: Al+Y
Virgin: V+I+Rg+In
pestana: P+Es+Ta+Na
falho: F+Al+H+O
bata: Ba+Ta
soarista: S+O+Ar+I+S+Ta
índico: I+Nd+I+C+O
Indesp: I+Nd+Es+P
Bogotá: B+Og+O+Ta
secura: Se+C+U+Ra
rey: Re+Y
reposteiro: Re+P+O+S+Te+Ir+O
ciar: C+I+Ar
berlinense: B+Er+Li+Ne+N+Se
bailundo: Ba+I+Lu+Nd+O
napolitano: Na+P+O+Li+Ta+N+O
circunstancial: C+Ir+C+U+N+S+Ta+N+C+I+Al
cansativo: Ca+N+S+At+I+V+O
generis: Ge+N+Er+I+S
caluniar: C+Al+U+N+I+Ar
basílica: B+As+I+Li+Ca
aspa: As+Pa
ne: Ne
France: F+Ra+N+Ce
fervura: F+Er+V+U+Ra
aspirina: As+P+Ir+I+Na
tirando: Ti+Ra+Nd+O
sarcástico: S+Ar+C+As+Ti+C+O
prepotente: P+Re+P+O+Te+N+Te
consentâneo: C+O+N+Se+N+Ta+Ne+O
coreografar: C+O+Re+Og+Ra+F+Ar
cálcio: C+Al+C+I+O
Nampula: N+Am+P+U+La
Garantias: Ga+Ra+N+Ti+As
freio: F+Re+I+O
Belas: Be+La+S
batalhar: B+At+Al+H+Ar
sionista: Si+O+N+I+S+Ta
Recife: Re+C+I+Fe
confluir: C+O+N+F+Lu+Ir
baila: Ba+I+La
sarau: S+Ar+Au
Paranhos: Pa+Ra+N+H+O+S
Nintendo: N+In+Te+Nd+O
coercivo: C+O+Er+C+I+V+O
au: Au
relutante: Re+Lu+Ta+N+Te
passional: P+As+Si+O+N+Al
parafrasear: Pa+Ra+F+Ra+Se+Ar
Está: Es+Ta
pomo: P+O+Mo
crista: Cr+I+S+Ta
clip: C+Li+P
homo: H+O+Mo
crispar: Cr+I+S+P+Ar
clone: Cl+O+Ne
boiar: B+O+I+Ar
linga: Li+N+Ga
line: Li+Ne
haste: H+As+Te
fulano: F+U+La+N+O
falsear: F+Al+Se+Ar
escarpa: Es+C+Ar+Pa
browser: Br+O+W+S+Er
pontão: P+O+N+Ta+O
invólucro: In+V+O+Lu+Cr+O
gabão: Ga+Ba+O
internato: In+Te+Rn+At+O
clareira: C+La+Re+I+Ra
repescar: Re+P+Es+C+Ar
parêntesis: Pa+Re+N+Te+Si+S
ócio: O+C+I+O
Botafogo: B+O+Ta+F+Og+O
gata: Ga+Ta
estafar: Es+Ta+F+Ar
ocaso: O+C+As+O
Caracas: C+Ar+Ac+As
Visconti: V+I+S+C+O+N+Ti
calvo: C+Al+V+O
Bari: B+Ar+I
vassoura: V+As+S+O+U+Ra
Parker: P+Ar+K+Er
nevar: Ne+V+Ar
hi: H+I
pote: P+O+Te
estio: Es+Ti+O
with: W+I+Th
perca: P+Er+Ca
bluff: B+Lu+F+F
Agostinho: Ag+O+S+Ti+N+H+O
Pirenéus: P+I+Re+N+Eu+S
insulina: In+S+U+Li+Na
inativo: In+At+I+V+O
ciclone: C+I+Cl+O+Ne
tabagismo: Ta+B+Ag+I+S+Mo
Op: O+P
Ohio: O+H+I+O
funcionalismo: F+U+N+C+I+O+N+Al+I+S+Mo
presságio: P+Re+S+S+Ag+I+O
po: P+O
intencionar: In+Te+N+C+I+O+N+Ar
amarra: Am+Ar+Ra
consternar: C+O+N+S+Te+Rn+Ar
confins: C+O+N+F+In+S
bávaro: Ba+V+Ar+O
setecentista: Se+Te+Ce+N+Ti+S+Ta
rapar: Ra+P+Ar
foca: F+O+Ca
Newark: Ne+W+Ar+K
focinho: F+O+C+In+H+O
berbere: B+Er+Be+Re
Baku: Ba+K+U
alfinete: Al+F+I+Ne+Te
frete: F+Re+Te
florescente: Fl+O+Re+S+Ce+N+Te
Bica: B+I+Ca
viga: V+I+Ga
vicentino: V+I+Ce+N+Ti+N+O
pupila: P+U+P+I+La
esburacar: Es+B+U+Ra+C+Ar
Couceiro: C+O+U+Ce+Ir+O
Simon: Si+Mo+N
chamuscar: C+H+Am+U+S+C+Ar
atinar: At+In+Ar
Arlindo: Ar+Li+Nd+O
gesso: Ge+S+S+O
clausura: C+La+U+S+U+Ra
facho: F+Ac+H+O
Albano: Al+Ba+N+O
up: U+P
Stasi: S+Ta+Si
nouo: N+O+U+O
Dylan: Dy+La+N
circulante: C+Ir+C+U+La+N+Te
atalho: At+Al+H+O
laivo: La+I+V+O
capitanear: Ca+P+I+Ta+Ne+Ar
Southampton: S+O+U+Th+Am+Pt+O+N
iconográfico: I+C+O+N+Og+Ra+F+I+C+O
contabilista: C+O+N+Ta+B+I+Li+S+Ta
circense: C+Ir+Ce+N+Se
cantinho: Ca+N+Ti+N+H+O
business: B+U+Si+N+Es+S
Fonsecas: F+O+N+Se+C+As
condescender: C+O+Nd+Es+Ce+Nd+Er
cercear: C+Er+Ce+Ar
valar: V+Al+Ar
PowerPC: P+O+W+Er+P+C
gaita: Ga+I+Ta
tino: Ti+N+O
préstimo: P+Re+S+Ti+Mo
cap: Ca+P
Ora: O+Ra
núpcias: N+U+P+C+I+As
campina: C+Am+P+I+Na
boina: B+O+I+Na
hepático: He+P+At+I+C+O
casebre: Ca+Se+B+Re
autista: Au+Ti+S+Ta
Seat: Se+At
ovar: O+V+Ar
oponente: O+P+O+Ne+N+Te
Frank: F+Ra+N+K
vip: V+I+P
tecnocrático: Te+C+N+O+C+Ra+Ti+C+O
raspar: Ra+S+P+Ar
Lino: Li+N+O
Constantinopla: C+O+N+S+Ta+N+Ti+N+O+P+La
cognitivo: C+Og+N+I+Ti+V+O
cannabis: Ca+N+Na+B+I+S
Acácio: Ac+Ac+I+O
lanche: La+N+C+He
Tahar: Ta+H+Ar
frondoso: Fr+O+Nd+O+S+O
copioso: C+O+P+I+O+S+O
labiríntico: La+B+Ir+In+Ti+C+O
convergente: C+O+N+V+Er+Ge+N+Te
conluio: C+O+N+Lu+I+O
Colin: C+O+Li+N
calão: Ca+La+O
vinícola: V+In+I+C+O+La
supersticioso: S+U+P+Er+S+Ti+C+I+O+S+O
monástico: Mo+N+As+Ti+C+O
frenesi: F+Re+N+Es+I
ovino: O+V+In+O
neofascista: Ne+O+F+As+C+I+S+Ta
lacticínio: La+C+Ti+C+In+I+O
hamburger: H+Am+B+U+Rg+Er
onipotente: O+N+I+P+O+Te+N+Te
fóra: F+O+Ra
bobo: B+O+B+O
vastíssimo: V+As+Ti+S+Si+Mo
ponteiro: P+O+N+Te+Ir+O
Cantão: Ca+N+Ta+O
bicentenário: B+I+Ce+N+Te+N+Ar+I+O
sege: Se+Ge
crear: C+Re+Ar
Baco: B+Ac+O
pag: P+Ag
beta: Be+Ta
tear: Te+Ar
plafond: P+La+F+O+Nd
bondoso: B+O+Nd+O+S+O
Rutskoi: Ru+Ts+K+O+I
crivo: Cr+I+V+O
banditismo: Ba+Nd+I+Ti+S+Mo
tai: Ta+I
espargir: Es+Pa+Rg+Ir
bucólico: B+U+C+O+Li+C+O
Whitewater: W+H+I+Te+W+At+Er
lavra: La+V+Ra
cineclube: C+I+Ne+C+Lu+Be
Ali: Al+I
laurear: La+U+Re+Ar
foraõ: F+O+Ra+O
campista: C+Am+P+I+S+Ta
cacau: C+Ac+Au
Pasolini: P+As+O+Li+N+I
atlas: At+La+S
Watergate: W+At+Er+Ga+Te
subchefe: S+U+B+C+He+Fe
esteio: Es+Te+I+O
espiga: Es+P+I+Ga
birra: B+Ir+Ra
vespertino: V+Es+P+Er+Ti+N+O
taipa: Ta+I+Pa
sufragar: S+U+Fr+Ag+Ar
psi: P+Si
gancho: Ga+N+C+H+O
batina: B+At+I+Na
pretensioso: P+Re+Te+N+Si+O+S+O
Pernambuco: P+Er+N+Am+B+U+C+O
libertino: Li+B+Er+Ti+N+O
geógrafo: Ge+Og+Ra+F+O
fuso: F+U+S+O
campal: C+Am+P+Al
vociferar: V+O+C+I+F+Er+Ar
Sé: Se
propo: Pr+O+P+O
Soponata: S+O+P+O+Na+Ta
resina: Re+Si+Na
infundir: In+F+U+Nd+Ir
Gates: Ga+Te+S
Cruges: C+Ru+Ge+S
son: S+O+N
serenata: Se+Re+Na+Ta
Papin: Pa+P+In
fraga: F+Ra+Ga
uivar: U+I+V+Ar
hooligan: H+O+O+Li+Ga+N
flanela: F+La+Ne+La
crash: C+Ra+S+H
confessional: C+O+N+F+Es+Si+O+N+Al
charneca: C+H+Ar+Ne+Ca
Castanheira: C+As+Ta+N+He+I+Ra
botânico: B+O+Ta+N+I+C+O
Sega: Se+Ga
rábula: Ra+B+U+La
náutica: N+Au+Ti+Ca
monopolista: Mo+N+O+P+O+Li+S+Ta
calafrio: Ca+La+Fr+I+O
carente: Ca+Re+N+Te
argentina: Ar+Ge+N+Ti+Na
acondicionar: Ac+O+Nd+I+C+I+O+N+Ar
Fini: F+In+I
cabala: Ca+Ba+La
Unicre: U+N+I+C+Re
sensacionalismo: Se+N+S+Ac+I+O+N+Al+I+S+Mo
bósnio: B+O+S+N+I+O
Artiach: Ar+Ti+Ac+H
sena: Se+Na
imobilismo: I+Mo+B+I+Li+S+Mo
hiato: H+I+At+O
General: Ge+N+Er+Al
parafuso: Pa+Ra+F+U+S+O
âmago: Am+Ag+O
farpar: F+Ar+P+Ar
escancarar: Es+Ca+N+C+Ar+Ar
Bayer: Ba+Y+Er
serial: S+Er+I+Al
PoSat: P+O+S+At
opressivo: O+P+Re+S+Si+V+O
lascivo: La+S+C+I+V+O
inconstante: In+C+O+N+S+Ta+N+Te
incinerar: In+C+In+Er+Ar
fenício: Fe+N+I+C+I+O
te: Te
Festina: F+Es+Ti+Na
recato: Re+C+At+O
Mourão: Mo+U+Ra+O
felino: Fe+Li+N+O
caserna: C+As+Er+Na
Calvário: C+Al+V+Ar+I+O
Brás: B+Ra+S
autismo: Au+Ti+S+Mo
mora: Mo+Ra
Tico: Ti+C+O
siso: Si+S+O
novato: N+O+V+At+O
geracional: Ge+Ra+C+I+O+N+Al
caucionar: C+Au+C+I+O+N+Ar
catarata: Ca+Ta+Ra+Ta
atípico: At+I+P+I+C+O
propagandístico: Pr+O+Pa+Ga+Nd+I+S+Ti+C+O
ovário: O+V+Ar+I+O
onerar: O+N+Er+Ar
gasolineira: Ga+S+O+Li+Ne+I+Ra
auio: Au+I+O
mono: Mo+N+O
flash: F+La+S+H
crasso: C+Ra+S+S+O
canário: Ca+N+Ar+I+O
retina: Re+Ti+Na
Claro: Cl+Ar+O
sufocante: S+U+F+O+Ca+N+Te
spray: S+P+Ra+Y
Escobar: Es+C+O+B+Ar
cintilante: C+In+Ti+La+N+Te
bisar: B+I+S+Ar
amplificar: Am+P+Li+F+I+C+Ar
centeio: Ce+N+Te+I+O
vertebral: V+Er+Te+Br+Al
tangencial: Ta+N+Ge+N+C+I+Al
profícuo: Pr+O+F+I+C+U+O
Ota: O+Ta
tipificar: Ti+P+I+F+I+C+Ar
Tintin: Ti+N+Ti+N
skin: S+K+In
revivalismo: Re+V+I+V+Al+I+S+Mo
Pacers: P+Ac+Er+S
Nando: Na+Nd+O
iniciático: In+I+C+I+At+I+C+O
Fialho: F+I+Al+H+O
facial: F+Ac+I+Al
cipreste: C+I+P+Re+S+Te
carabina: Ca+Ra+B+I+Na
arfar: Ar+F+Ar
Vukovar: V+U+K+O+V+Ar
unico: U+N+I+C+O
Cáceres: C+Ac+Er+Es
bogey: B+O+Ge+Y
altista: Al+Ti+S+Ta
paternalista: P+At+Er+N+Al+I+S+Ta
Solino: S+O+Li+N+O
chupar: C+H+U+P+Ar
psicose: P+Si+C+O+Se
hera: He+Ra
Simone: Si+Mo+Ne
Per: P+Er
palheiro: P+Al+He+Ir+O
ferrenho: F+Er+Re+N+H+O
assomo: As+S+O+Mo
virginal: V+I+Rg+In+Al
salmo: S+Al+Mo
refrega: Re+F+Re+Ga
galã: Ga+La
balístico: B+Al+I+S+Ti+C+O
auréola: Au+Re+O+La
víveres: V+I+V+Er+Es
cio: C+I+O
ac: Ac
pinta: P+In+Ta
palpite: P+Al+P+I+Te
caríssimo: C+Ar+I+S+Si+Mo
Uíge: U+I+Ge
Stich: S+Ti+C+H
Solana: S+O+La+Na
parceira: P+Ar+Ce+I+Ra
Hergé: H+Er+Ge
fundiário: F+U+Nd+I+Ar+I+O
crespo: C+Re+S+P+O
piscícola: P+I+S+C+I+C+O+La
binário: B+In+Ar+I+O
Bali: B+Al+I
Continente: C+O+N+Ti+Ne+N+Te
bestial: Be+S+Ti+Al
teclista: Te+C+Li+S+Ta
Sacchi: S+Ac+C+H+I
raciocinar: Ra+C+I+O+C+In+Ar
peru: P+Er+U
Paulão: P+Au+La+O
esclerose: Es+Cl+Er+O+Se
superlativo: S+U+P+Er+La+Ti+V+O
Renoir: Re+N+O+Ir
Orfeu: O+Rf+Eu
neblina: Ne+B+Li+Na
Nancy: Na+N+C+Y
McCarthy: Mc+C+Ar+Th+Y
ornato: O+Rn+At+O
Sonics: S+O+N+I+C+S
partio: P+Ar+Ti+O
Nepal: Ne+P+Al
mó: Mo
culinário: C+U+Li+N+Ar+I+O
Cícero: C+I+C+Er+O
batota: B+At+O+Ta
Viagra: V+I+Ag+Ra
Árvore: Ar+V+O+Re
espasmo: Es+P+As+Mo
catão: Ca+Ta+O
óbice: O+B+I+Ce
barata: Ba+Ra+Ta
Tires: Ti+Re+S
precaver: P+Re+Ca+V+Er
Esteves: Es+Te+V+Es
estalinismo: Es+Ta+Li+N+I+S+Mo
superintender: S+U+P+Er+In+Te+Nd+Er
rês: Re+S
montão: Mo+N+Ta+O
latão: La+Ta+O
kosovar: K+O+S+O+V+Ar
internacionalista: In+Te+Rn+Ac+I+O+N+Al+I+S+Ta
fogoso: F+Og+O+S+O
coco: C+O+C+O
choupo: C+H+O+U+P+O
universalista: U+N+I+V+Er+S+Al+I+S+Ta
iceberg: I+Ce+Be+Rg
falsar: F+Al+S+Ar
bebop: Be+B+O+P
cenográfico: Ce+N+Og+Ra+F+I+C+O
caco: C+Ac+O
voluptuoso: V+O+Lu+Pt+U+O+S+O
Refer: Re+F+Er
polaca: P+O+La+Ca
hauer: H+Au+Er
sarin: S+Ar+In
arranhar: Ar+Ra+N+H+Ar
play: P+La+Y
Ita: I+Ta
curativo: C+U+Ra+Ti+V+O
víscera: V+I+S+Ce+Ra
Patrese: P+At+Re+Se
fofo: F+O+F+O
cataclismo: C+At+Ac+Li+S+Mo
saciar: S+Ac+I+Ar
Indochina: I+Nd+O+C+H+I+Na
sir: S+Ir
sintaxe: Si+N+Ta+Xe
Píndaro: P+I+Nd+Ar+O
plu: P+Lu
forão: F+O+Ra+O
ferreiro: F+Er+Re+Ir+O
baralho: B+Ar+Al+H+O
sarampo: S+Ar+Am+P+O
rebuscar: Re+B+U+S+C+Ar
pastiche: P+As+Ti+C+He
os: O+S
celibato: Ce+Li+B+At+O
Cabanelas: Ca+Ba+Ne+La+S
pateta: Pa+Te+Ta
Navarra: Na+V+Ar+Ra
invisual: In+V+I+S+U+Al
autenticar: Au+Te+N+Ti+C+Ar
sífilis: Si+F+I+Li+S
pré: P+Re
ovni: O+V+N+I
naturalismo: N+At+U+Ra+Li+S+Mo
Irene: I+Re+Ne
inato: In+At+O
Francis: F+Ra+N+C+I+S
Arsénio: Ar+Se+N+I+O
Utah: U+Ta+H
Karpov: K+Ar+P+O+V
Gala: Ga+La
circunstante: C+Ir+C+U+N+S+Ta+N+Te
cata: Ca+Ta
vingativo: V+In+Ga+Ti+V+O
verberar: V+Er+B+Er+Ar
friso: Fr+I+S+O
bálsamo: B+Al+S+Am+O
Batista: B+At+I+S+Ta
Vichy: V+I+C+H+Y
sy: S+Y
subornar: S+U+B+O+Rn+Ar
sarcófago: S+Ar+C+O+F+Ag+O
árctico: Ar+C+Ti+C+O
néscio: N+Es+C+I+O
lastimoso: La+S+Ti+Mo+S+O
Inocêncio: In+O+Ce+N+C+I+O
coar: C+O+Ar
CiU: C+I+U
canseira: Ca+N+Se+I+Ra
calunioso: C+Al+U+N+I+O+S+O
alpino: Al+P+In+O
Titi: Ti+Ti
Tarantino: Ta+Ra+N+Ti+N+O
gasoso: Ga+S+O+S+O
estanho: Es+Ta+N+H+O
ceifar: Ce+I+F+Ar
catarse: C+At+Ar+Se
bi: B+I
vogar: V+Og+Ar
sucessora: S+U+C+Es+S+O+Ra
conciso: C+O+N+C+I+S+O
centavo: Ce+N+Ta+V+O
carcereiro: C+Ar+Ce+Re+Ir+O
caramba: C+Ar+Am+Ba
Sorbonne: S+O+Rb+O+N+Ne
sela: Se+La
Perú: P+Er+U
nenh: Ne+N+H
espraiar: Es+P+Ra+I+Ar
careta: Ca+Re+Ta
barranco: B+Ar+Ra+N+C+O
ocupacional: O+C+U+P+Ac+I+O+N+Al
cheiroso: C+He+Ir+O+S+O
Bucelas: B+U+Ce+La+S
psicopata: P+Si+C+O+Pa+Ta
Mora: Mo+Ra
mocho: Mo+C+H+O
lupa: Lu+Pa
aglutinar: Ag+Lu+Ti+N+Ar
policiário: P+O+Li+C+I+Ar+I+O
garfo: Ga+Rf+O
Lipcsei: Li+P+C+Se+I
Honduras: H+O+Nd+U+Ra+S
gebo: Ge+B+O
rarear: Ra+Re+Ar
platina: P+La+Ti+Na
Lacticoop: La+C+Ti+C+O+O+P
isco: I+S+C+O
fresta: F+Re+S+Ta
cheirinho: C+He+Ir+In+H+O
bretão: B+Re+Ta+O
bege: Be+Ge
usura: U+S+U+Ra
rá: Ra
pacense: Pa+Ce+N+Se
Bétis: Be+Ti+S
bafo: Ba+F+O
Nam: N+Am
naco: N+Ac+O
Lage: La+Ge
Hernâni: H+Er+Na+N+I
Gandhi: Ga+Nd+H+I
fastio: F+As+Ti+O
crivar: Cr+I+V+Ar
Moreirense: Mo+Re+I+Re+N+Se
esporão: Es+P+O+Ra+O
cone: C+O+Ne
agasalho: Ag+As+Al+H+O
Tancos: Ta+N+C+O+S
repassar: Re+P+As+S+Ar
Pai: Pa+I
Nandinho: Na+Nd+In+H+O
Monk: Mo+N+K
Honecker: H+O+Ne+C+K+Er
acutilante: Ac+U+Ti+La+N+Te
recepcionista: Re+Ce+P+C+I+O+N+I+S+Ta
oferente: O+Fe+Re+N+Te
insuflar: In+S+U+Fl+Ar
freático: F+Re+At+I+C+O
responsar: Re+S+P+O+N+S+Ar
opcional: O+P+C+I+O+N+Al
obscurantismo: O+B+S+C+U+Ra+N+Ti+S+Mo
gays: Ga+Y+S
crosta: Cr+O+S+Ta
hipnótico: H+I+P+N+O+Ti+C+O
escaparate: Es+Ca+Pa+Ra+Te
canino: Ca+N+In+O
Bono: B+O+N+O
Bibi: B+I+B+I
atte: At+Te
regenerar: Re+Ge+N+Er+Ar
pascal: P+As+C+Al
palpitante: P+Al+P+I+Ta+N+Te
nupcial: N+U+P+C+I+Al
genealógico: Ge+Ne+Al+Og+I+C+O
fraternal: F+Ra+Te+Rn+Al
Coutinho: C+O+U+Ti+N+H+O
Neptuno: Ne+Pt+U+N+O
lince: Li+N+Ce
Verona: V+Er+O+Na
sin: Si+N
Ray: Ra+Y
prendar: P+Re+Nd+Ar
patinar: P+At+In+Ar
paisagista: Pa+I+S+Ag+I+S+Ta
finta: F+In+Ta
Fassbinder: F+As+S+B+I+Nd+Er
sinónimo: Si+N+O+N+I+Mo
rubi: Ru+B+I
orgasmo: O+Rg+As+Mo
lage: La+Ge
cliché: C+Li+C+He
America: Am+Er+I+Ca
viseu: V+I+S+Eu
uas: U+As
narcótico: N+Ar+C+O+Ti+C+O
inalar: In+Al+Ar
cambalhota: C+Am+B+Al+H+O+Ta
vitivinícola: V+I+Ti+V+In+I+C+O+La
tangente: Ta+N+Ge+N+Te
offer: O+F+F+Er
Nicolau: N+I+C+O+La+U
Carvalheiras: C+Ar+V+Al+He+I+Ra+S
carnal: C+Ar+N+Al
alar: Al+Ar
paralítico: P+Ar+Al+I+Ti+C+O
papão: Pa+Pa+O
Ímola: I+Mo+La
Veríssimo: V+Er+I+S+Si+Mo
Pires: P+I+Re+S
ioga: I+O+Ga
cavo: Ca+V+O
vero: V+Er+O
Silvério: Si+Lv+Er+I+O
senar: Se+N+Ar
ravina: Ra+V+I+Na
notebook: N+O+Te+B+O+O+K
Fary: F+Ar+Y
bússola: B+U+S+S+O+La
Auckland: Au+C+K+La+Nd
verga: V+Er+Ga
team: Te+Am
coio: C+O+I+O
caneca: Ca+Ne+Ca
Barclays: B+Ar+C+La+Y+S
bagatela: Ba+Ga+Te+La
tinteiro: Ti+N+Te+Ir+O
reunificar: Re+U+N+I+F+I+C+Ar
repar: Re+P+Ar
plátano: P+La+Ta+N+O
Pierre: P+I+Er+Re
Panic: Pa+N+I+C
Heat: He+At
carreiro: C+Ar+Re+Ir+O
agachar: Ag+Ac+H+Ar
varar: V+Ar+Ar
liteira: Li+Te+I+Ra
linfático: Li+N+F+At+I+C+O
carpir: C+Ar+P+Ir
amir: Am+Ir
Puccini: P+U+C+C+In+I
Cook: C+O+O+K
bichinho: B+I+C+H+In+H+O
pâncreas: Pa+N+C+Re+As
Neca: Ne+Ca
link: Li+N+K
liceal: Li+Ce+Al
escriba: Es+Cr+I+Ba
Crato: Cr+At+O
sebe: Se+Be
recessivo: Re+C+Es+Si+V+O
Bispo: B+I+S+P+O
bibliotecário: B+I+B+Li+O+Te+C+Ar+I+O
agrura: Ag+Ru+Ra
Rainey: Ra+I+Ne+Y
pratear: P+Ra+Te+Ar
fecundar: Fe+C+U+Nd+Ar
cubar: C+U+B+Ar
Claes: C+La+Es
bramir: Br+Am+Ir
amoreira: Am+O+Re+I+Ra
pontifício: P+O+N+Ti+F+I+C+I+O
finura: F+In+U+Ra
Chichisbéu: C+H+I+C+H+I+S+Be+U
Campo: C+Am+P+O
barbear: B+Ar+Be+Ar
back: B+Ac+K
Você: V+O+Ce
Soyo: S+O+Y+O
recobrar: Re+C+O+Br+Ar
reagrupar: Re+Ag+Ru+P+Ar
incandescente: In+Ca+Nd+Es+Ce+N+Te
Corfu: C+O+Rf+U
car: C+Ar
Bundesliga: B+U+Nd+Es+Li+Ga
subentender: S+U+Be+N+Te+Nd+Er
obscurecer: O+B+S+C+U+Re+C+Er
Klaus: K+La+U+S
charneira: C+H+Ar+Ne+I+Ra
bravio: B+Ra+V+I+O
Thern: Th+Er+N
Induráin: I+Nd+U+Ra+In
achega: Ac+He+Ga
Sou: S+O+U
néon: Ne+O+N
fatalismo: F+At+Al+I+S+Mo
casario: C+As+Ar+I+O
calcinar: C+Al+C+In+Ar
Alípio: Al+I+P+I+O
alcunhar: Al+C+U+N+H+Ar
tico: Ti+C+O
pinga: P+In+Ga
nacer: N+Ac+Er
fresca: F+Re+S+Ca
víbora: V+I+B+O+Ra
suco: S+U+C+O
Sra: S+Ra
scanner: S+Ca+N+N+Er
Parkinson: P+Ar+K+In+S+O+N
mouco: Mo+U+C+O
fonográfico: F+O+N+Og+Ra+F+I+C+O
chinela: C+H+I+Ne+La
Bruges: B+Ru+Ge+S
vacilante: V+Ac+I+La+N+Te
Técnico: Te+C+N+I+C+O
sobrante: S+O+B+Ra+N+Te
rascunho: Ra+S+C+U+N+H+O
pino: P+In+O
fruir: F+Ru+Ir
flashe: F+La+S+He
barreiro: B+Ar+Re+Ir+O
alfarrabista: Al+F+Ar+Ra+B+I+S+Ta
acerbo: Ac+Er+B+O
terapeuta: Te+Ra+P+Eu+Ta
Rai: Ra+I
Bosch: B+O+S+C+H
Bergkamp: Be+Rg+K+Am+P
www: W+W+W
Távora: Ta+V+O+Ra
suplicante: S+U+P+Li+Ca+N+Te
lula: Lu+La
infindo: In+F+I+Nd+O
chita: C+H+I+Ta
Camac: C+Am+Ac
Baltimore: B+Al+Ti+Mo+Re
Bahrein: Ba+H+Re+In
acre: Ac+Re
Scalfaro: S+C+Al+F+Ar+O
Sacatrapo: S+Ac+At+Ra+P+O
pipoca: P+I+P+O+Ca
Pav: Pa+V
lanifício: La+N+I+F+I+C+I+O
espora: Es+P+O+Ra
cantata: Ca+N+Ta+Ta
Barra: B+Ar+Ra
Kobe: K+O+Be
gana: Ga+Na
estacionário: Es+Ta+C+I+O+N+Ar+I+O
crack: C+Ra+C+K
Cirene: C+I+Re+Ne
Cali: C+Al+I
Calcutá: C+Al+C+U+Ta
th: Th
indigente: I+Nd+I+Ge+N+Te
heptatlo: He+P+Ta+Tl+O
Águas: Ag+U+As
falacioso: F+Al+Ac+I+O+S+O
cutâneo: C+U+Ta+Ne+O
Cesariny: C+Es+Ar+In+Y
Ceilão: Ce+I+La+O
Cavaliers: Ca+V+Al+I+Er+S
Altis: Al+Ti+S
teso: Te+S+O
Proteu: Pr+O+Te+U
proibitivo: Pr+O+I+B+I+Ti+V+O
Fontes: F+O+N+Te+S
feno: Fe+N+O
cicerone: C+I+C+Er+O+Ne
cepa: Ce+Pa
Alcácer: Al+C+Ac+Er
visceral: V+I+S+C+Er+Al
sse: S+Se
protão: Pr+O+Ta+O
pouo: P+O+U+O
inconsistente: In+C+O+N+Si+S+Te+N+Te
carniceiro: C+Ar+N+I+Ce+Ir+O
calculista: C+Al+C+U+Li+S+Ta
opróbrio: O+Pr+O+Br+I+O
Laos: La+O+S
Ionesco: I+O+N+Es+C+O
calo: C+Al+O
Alasca: Al+As+Ca
Tchekov: Tc+He+K+O+V
Salvaterra: S+Al+V+At+Er+Ra
plateau: P+La+Te+Au
patife: P+At+I+Fe
Natário: N+At+Ar+I+O
ganês: Ga+N+Es
Clark: Cl+Ar+K
Cherbakov: C+H+Er+Ba+K+O+V
asseio: As+Se+I+O
papo: Pa+P+O
incarnar: In+C+Ar+N+Ar
Bárbara: B+Ar+Ba+Ra
alpinista: Al+P+In+I+S+Ta
ficcionar: F+I+C+C+I+O+N+Ar
violão: V+I+O+La+O
ui: U+I
ressarcir: Re+S+S+Ar+C+Ir
pirotécnico: P+Ir+O+Te+C+N+I+C+O
pause: P+Au+Se
frutificar: F+Ru+Ti+F+I+C+Ar
Coina: C+O+I+Na
retaliar: Re+Ta+Li+Ar
reservista: Re+S+Er+V+I+S+Ta
Playboy: P+La+Y+B+O+Y
indiciário: I+Nd+I+C+I+Ar+I+O
cafeína: Ca+Fe+I+Na
Aguiar: Ag+U+I+Ar
viés: V+I+Es
Sharon: S+H+Ar+O+N
know: K+N+O+W
iconoclasta: I+C+O+N+O+C+La+S+Ta
cabaré: Ca+Ba+Re
bonina: B+O+N+I+Na
beatificar: Be+At+I+F+I+C+Ar
Barcelinhos: B+Ar+Ce+Li+N+H+O+S
Sob: S+O+B
raivoso: Ra+I+V+O+S+O
pêro: P+Er+O
persuasivo: P+Er+S+U+As+I+V+O
paternalismo: P+At+Er+N+Al+I+S+Mo
larápio: La+Ra+P+I+O
Kravtchuk: K+Ra+V+Tc+H+U+K
garbo: Ga+Rb+O
coreu: C+O+Re+U
arar: Ar+Ar
socalco: S+O+C+Al+C+O
repicar: Re+P+I+C+Ar
indirecta: I+Nd+I+Re+C+Ta
claríssimo: Cl+Ar+I+S+Si+Mo
Cabrita: Ca+Br+I+Ta
baixela: Ba+I+Xe+La
assacar: As+S+Ac+Ar
val: V+Al
Política: P+O+Li+Ti+Ca
lilás: Li+La+S
galanteio: Ga+La+N+Te+I+O
Francisca: F+Ra+N+C+I+S+Ca
clerical: Cl+Er+I+C+Al
Cisf: C+I+S+F
casuístico: C+As+U+I+S+Ti+C+O
baioneta: Ba+I+O+Ne+Ta
islandês: I+S+La+Nd+Es
inca: In+Ca
herético: He+Re+Ti+C+O
fariseu: F+Ar+I+S+Eu
Esc: Es+C
Baltasar: B+Al+Ta+S+Ar
seiscentista: Se+I+S+Ce+N+Ti+S+Ta
ofegante: O+Fe+Ga+N+Te
gaiteiro: Ga+I+Te+Ir+O
espinhenses: Es+P+In+He+N+S+Es
Clio: C+Li+O
vaticínio: V+At+I+C+In+I+O
República: Re+P+U+B+Li+Ca
mondar: Mo+Nd+Ar
cristã: Cr+I+S+Ta
chic: C+H+I+C
Capra: Ca+P+Ra
bébé: Be+Be
Tenho: Te+N+H+O
rectificativo: Re+C+Ti+F+I+C+At+I+V+O
raposo: Ra+P+O+S+O
finíssimo: F+In+I+S+Si+Mo
bufo: B+U+F+O
Albarran: Al+B+Ar+Ra+N
racionalismo: Ra+C+I+O+N+Al+I+S+Mo
oblige: O+B+Li+Ge
nòs: N+O+S
forense: F+O+Re+N+Se
Carneiro: C+Ar+Ne+Ir+O
Sparta: S+P+Ar+Ta
seriar: S+Er+I+Ar
Reys: Re+Y+S
paranóico: Pa+Ra+N+O+I+C+O
provocante: Pr+O+V+O+Ca+N+Te
pragal: Pr+Ag+Al
parreira: P+Ar+Re+I+Ra
bureau: B+U+Re+Au
boticário: B+O+Ti+C+Ar+I+O
Alcino: Al+C+In+O
vous: V+O+U+S
ressonar: Re+S+S+O+N+Ar
racionalista: Ra+C+I+O+N+Al+I+S+Ta
Cesário: C+Es+Ar+I+O
ascético: As+Ce+Ti+C+O
Amato: Am+At+O
windsurf: W+In+Ds+U+Rf
teclar: Te+Cl+Ar
Suker: S+U+K+Er
sucateiro: S+U+Ca+Te+Ir+O
Luis: Lu+I+S
Liga: Li+Ga
caprino: Ca+Pr+In+O
vértebra: V+Er+Te+B+Ra
Passos: P+As+S+O+S
lancinante: La+N+C+I+Na+N+Te
febra: Fe+B+Ra
tecnicista: Te+C+N+I+C+I+S+Ta
sertã: S+Er+Ta
reclinar: Re+C+Li+N+Ar
noctívago: N+O+C+Ti+V+Ag+O
nabo: Na+B+O
hípico: H+I+P+I+C+O
as: As
Versalhes: V+Er+S+Al+H+Es
tigela: Ti+Ge+La
obstinar: O+B+S+Ti+N+Ar
flashback: F+La+S+H+B+Ac+K
finais: F+I+Na+I+S
escabroso: Es+Ca+Br+O+S+O
charlatão: C+H+Ar+La+Ta+O
Blackburn: B+La+C+K+B+U+Rn
Tete: Te+Te
possesso: P+O+S+S+Es+S+O
pager: P+Ag+Er
cu: C+U
concertina: C+O+N+C+Er+Ti+Na
am: Am
alvura: Al+V+U+Ra
revivalista: Re+V+I+V+Al+I+S+Ta
pantera: Pa+N+Te+Ra
osmose: O+S+Mo+Se
Horn: H+O+Rn
cris: Cr+I+S
blasfemo: B+La+S+Fe+Mo
belicista: Be+Li+C+I+S+Ta
atras: At+Ra+S
Sófocles: S+O+F+O+Cl+Es
Secundário: Se+C+U+Nd+Ar+I+O
repo: Re+P+O
Rep: Re+P
pires: P+I+Re+S
Nobre: N+O+B+Re
Estas: Es+Ta+S
Creta: C+Re+Ta
Brcko: Br+C+K+O
Bob: B+O+B
Rennes: Re+N+N+Es
potássio: P+O+Ta+S+Si+O
colaboracionista: C+O+La+B+O+Ra+C+I+O+N+I+S+Ta
coagir: C+O+Ag+Ir
Ceausescu: Ce+Au+S+Es+C+U
Price: Pr+I+Ce
Lisgráfica: Li+Sg+Ra+F+I+Ca
Lierse: Li+Er+Se
infamar: In+F+Am+Ar
Bobó: B+O+B+O
Biasion: B+I+As+I+O+N
ato: At+O
Assírio: As+S+Ir+I+O
sincretismo: Si+N+C+Re+Ti+S+Mo
prenhe: P+Re+N+He
pav: Pa+V
flop: Fl+O+P
Crisal: Cr+I+S+Al
cifrão: C+I+F+Ra+O
cepo: Ce+P+O
cahir: Ca+H+Ir
Natgás: N+At+Ga+S
isca: I+S+Ca
feiticeira: Fe+I+Ti+Ce+I+Ra
clubístico: C+Lu+B+I+S+Ti+C+O
cetáceo: Ce+Ta+Ce+O
Cagliari: C+Ag+Li+Ar+I
praceta: P+Ra+Ce+Ta
opus: O+P+U+S
nasal: N+As+Al
lácteo: La+C+Te+O
auiar: Au+I+Ar
proselitismo: Pr+O+Se+Li+Ti+S+Mo
parca: P+Ar+Ca
ocre: O+C+Re
fixe: F+I+Xe
atual: At+U+Al
taverna: Ta+V+Er+Na
hélice: He+Li+Ce
cunhar: C+U+N+H+Ar
calhau: C+Al+H+Au
belicoso: Be+Li+C+O+S+O
tipógrafo: Ti+P+Og+Ra+F+O
liberar: Li+B+Er+Ar
Lawrence: La+W+Re+N+Ce
latifundiário: La+Ti+F+U+Nd+I+Ar+I+O
Gestifundo: Ge+S+Ti+F+U+Nd+O
gesta: Ge+S+Ta
gd: Gd
conspirativo: C+O+N+S+P+I+Ra+Ti+V+O
canibal: Ca+N+I+B+Al
Vós: V+O+S
russófono: Ru+S+S+O+F+O+N+O
Popper: P+O+P+P+Er
hip: H+I+P
frauta: F+Ra+U+Ta
esferográfica: Es+F+Er+Og+Ra+F+I+Ca
chacota: C+H+Ac+O+Ta
sikh: Si+K+H
Sete: Se+Te
server: S+Er+V+Er
refrescante: Re+F+Re+S+Ca+N+Te
peruca: P+Er+U+Ca
latina: La+Ti+Na
Fogo: F+Og+O
congestão: C+O+N+Ge+S+Ta+O
archote: Ar+C+H+O+Te
piropo: P+Ir+O+P+O
Patten: P+At+Te+N
Palatsi: P+Al+At+Si
molusco: Mo+Lu+S+C+O
ita: I+Ta
Francês: F+Ra+N+C+Es
fermosura: F+Er+Mo+S+U+Ra
cs: C+S
Carrascalão: C+Ar+Ra+S+Ca+La+O
Barata: Ba+Ra+Ta
acercar: Ac+Er+C+Ar
Reich: Re+I+C+H
Pina: P+I+Na
narcisismo: N+Ar+C+I+Si+S+Mo
hop: H+O+P
funky: F+U+N+K+Y
espinhense: Es+P+In+He+N+Se
bulício: B+U+Li+C+I+O
Bei: Be+I
Sena: Se+Na
Salónica: S+Al+O+N+I+Ca
piar: P+I+Ar
paliativo: P+Al+I+At+I+V+O
Krabbe: K+Ra+B+Be
hobby: H+O+B+B+Y
byte: B+Y+Te
ugandês: U+Ga+Nd+Es
sebo: Se+B+O
picaresco: P+I+C+Ar+Es+C+O
pantanal: Pa+N+Ta+N+Al
hipismo: H+I+P+I+S+Mo
Genesis: Ge+N+Es+I+S
Cofina: C+O+F+I+Na
Careca: Ca+Re+Ca
aluir: Al+U+Ir
uivo: U+I+V+O
parvoíce: P+Ar+V+O+I+Ce
la: La
Calheiros: C+Al+He+Ir+O+S
soalheiro: S+O+Al+He+Ir+O
Sinai: Si+Na+I
sauna: S+Au+Na
porfiar: P+O+Rf+I+Ar
periclitante: P+Er+I+C+Li+Ta+N+Te
pagante: Pa+Ga+N+Te
Linhó: Li+N+H+O
interesseiro: In+Te+Re+S+Se+Ir+O
Coopers: C+O+O+P+Er+S
celulite: Ce+Lu+Li+Te
vestiário: V+Es+Ti+Ar+I+O
Pará: Pa+Ra
morgar: Mo+Rg+Ar
morfina: Mo+Rf+I+Na
Isaura: I+S+Au+Ra
Cessna: C+Es+S+Na
Bonaparte: B+O+Na+P+Ar+Te
rasar: Ra+S+Ar
Raí: Ra+I
morena: Mo+Re+Na
mg: Mg
Hagi: H+Ag+I
Forbes: F+O+Rb+Es
cosmopolitismo: C+O+S+Mo+P+O+Li+Ti+S+Mo
camiseiro: C+Am+I+Se+Ir+O
bambo: B+Am+B+O
Amo: Am+O
profundas: Pr+O+F+U+Nd+As
neoclássico: Ne+O+C+La+S+Si+C+O
âmbar: Am+B+Ar
Irvine: Ir+V+I+Ne
hélio: He+Li+O
cesta: C+Es+Ta
catar: C+At+Ar
canavial: Ca+Na+V+I+Al
Bernstein: Be+Rn+S+Te+In
You: Y+O+U
Tina: Ti+Na
rutilante: Ru+Ti+La+N+Te
refresco: Re+F+Re+S+C+O
Pois: P+O+I+S
Ofir: O+F+Ir
lúbrico: Lu+Br+I+C+O
Essen: Es+Se+N
cigana: C+I+Ga+Na
caritativo: C+Ar+I+Ta+Ti+V+O
Sukarno: S+U+K+Ar+N+O
Sauber: S+Au+B+Er
psicanalítico: P+Si+Ca+N+Al+I+Ti+C+O
Pinheiro: P+In+He+Ir+O
palpar: P+Al+P+Ar
Outão: O+U+Ta+O
Kivu: K+I+V+U
Falcone: F+Al+C+O+Ne
círio: C+Ir+I+O
bambu: B+Am+B+U
Seu: S+Eu
Narana: Na+Ra+Na
inactivo: In+Ac+Ti+V+O
ciclópico: C+I+Cl+O+P+I+C+O
ce: Ce
Barcarena: B+Ar+Ca+Re+Na
arrendatário: Ar+Re+Nd+At+Ar+I+O
alcorão: Al+C+O+Ra+O
viscoso: V+I+S+C+O+S+O
Teu: Te+U
Tanta: Ta+N+Ta
sub: S+U+B
rúbrica: Ru+Br+I+Ca
prontificar: Pr+O+N+Ti+F+I+C+Ar
Oikos: O+I+K+O+S
novinho: N+O+V+In+H+O
Nehru: Ne+H+Ru
libré: Li+B+Re
Ibsen: I+B+Se+N
fosfato: F+O+S+F+At+O
florentino: Fl+O+Re+N+Ti+N+O
artificioso: Ar+Ti+F+I+C+I+O+S+O
Vargas: V+Ar+Ga+S
Sta: S+Ta
sebenta: Se+Be+N+Ta
monteiro: Mo+N+Te+Ir+O
Burgos: B+U+Rg+O+S
barraco: B+Ar+Ra+C+O
Bahamas: Ba+H+Am+As
yes: Y+Es
Salinas: S+Al+In+As
Polanski: P+O+La+N+S+K+I
Nabão: Na+Ba+O
ci: C+I
Black: B+La+C+K
placar: P+La+C+Ar
patos: P+At+O+S
cábula: Ca+B+U+La
búfalo: B+U+F+Al+O
amaciar: Am+Ac+I+Ar
that: Th+At
ten: Te+N
subavaliar: S+U+Ba+V+Al+I+Ar
silicone: Si+Li+C+O+Ne
rasteira: Ra+S+Te+I+Ra
preparo: P+Re+P+Ar+O
Pierce: P+I+Er+Ce
pantanoso: Pa+N+Ta+N+O+S+O
Pandora: Pa+Nd+O+Ra
Nero: N+Er+O
mon: Mo+N
Caminho: C+Am+In+H+O
boer: B+O+Er
besteiro: Be+S+Te+Ir+O
assistencial: As+Si+S+Te+N+C+I+Al
Vialli: V+I+Al+Li
retinir: Re+Ti+N+Ir
recife: Re+C+I+Fe
parteira: P+Ar+Te+I+Ra
converso: C+O+N+V+Er+S+O
catana: Ca+Ta+Na
carrear: C+Ar+Re+Ar
Sis: Si+S
reocupar: Re+O+C+U+P+Ar
Pinho: P+In+H+O
online: O+N+Li+Ne
moita: Mo+I+Ta
Life: Li+Fe
ganso: Ga+N+S+O
fonético: F+O+Ne+Ti+C+O
Feirense: Fe+I+Re+N+Se
cl: Cl
Cinco: C+In+C+O
catre: C+At+Re
assoprar: As+S+O+Pr+Ar
professo: Pr+O+F+Es+S+O
certinho: C+Er+Ti+N+H+O
socar: S+O+C+Ar
officio: O+F+F+I+C+I+O
lisura: Li+S+U+Ra
champagne: C+H+Am+P+Ag+Ne
barbatana: B+Ar+Ba+Ta+Na
Américo: Am+Er+I+C+O
tinir: Ti+N+Ir
Perth: P+Er+Th
Gaúcho: Ga+U+C+H+O
Breves: B+Re+V+Es
Boban: B+O+Ba+N
Timóteo: Ti+Mo+Te+O
rufar: Ru+F+Ar
ouuer: O+U+U+Er
Inô: In+O
Fischer: F+I+S+C+H+Er
Eunice: Eu+N+I+Ce
esfinge: Es+F+In+Ge
bronca: Br+O+N+Ca
tan: Ta+N
recalcar: Re+C+Al+C+Ar
Clippers: C+Li+P+P+Er+S
breviário: B+Re+V+I+Ar+I+O
soffrer: S+O+F+Fr+Er
revisteiro: Re+V+I+S+Te+Ir+O
Calvin: C+Al+V+In
arrear: Ar+Re+Ar
Agusta: Ag+U+S+Ta
agoiro: Ag+O+Ir+O
Vila: V+I+La
tecno: Te+C+N+O
sineta: Si+Ne+Ta
Samouco: S+Am+O+U+C+O
Íris: Ir+I+S
pt: Pt
piroso: P+Ir+O+S+O
ovacionar: O+V+Ac+I+O+N+Ar
moiro: Mo+Ir+O
incluíndo: In+C+Lu+I+Nd+O
Fagundes: F+Ag+U+Nd+Es
cr: Cr
clonar: Cl+O+N+Ar
Carta: C+Ar+Ta
Brunei: B+Ru+Ne+I
Bruce: B+Ru+Ce
script: S+Cr+I+Pt
rabeca: Ra+Be+Ca
monegasco: Mo+Ne+Ga+S+C+O
cossaco: C+O+S+S+Ac+O
Cooperativo: C+O+O+P+Er+At+I+V+O
Canon: Ca+N+O+N
alvorecer: Al+V+O+Re+C+Er
tendinite: Te+Nd+In+I+Te
relativismo: Re+La+Ti+V+I+S+Mo
Ratinho: Ra+Ti+N+H+O
land: La+Nd
fontanário: F+O+N+Ta+N+Ar+I+O
Finibanco: F+In+I+Ba+N+C+O
coxear: C+O+Xe+Ar
cochichar: C+O+C+H+I+C+H+Ar
Albacete: Al+Ba+Ce+Te
Unisys: U+N+I+S+Y+S
recrear: Re+C+Re+Ar
protestantismo: Pr+O+Te+S+Ta+N+Ti+S+Mo
prefaciar: P+Re+F+Ac+I+Ar
Playstation: P+La+Y+S+Ta+Ti+O+N
Montes: Mo+N+Te+S
latifúndio: La+Ti+F+U+Nd+I+O
isolacionista: I+S+O+La+C+I+O+N+I+S+Ta
indigestão: I+Nd+I+Ge+S+Ta+O
hein: He+In
fluorescente: F+Lu+O+Re+S+Ce+N+Te
sn: S+N
Sion: Si+O+N
rabino: Ra+B+In+O
procela: Pr+O+Ce+La
Ouattara: O+U+At+Ta+Ra
nepotismo: Ne+P+O+Ti+S+Mo
foyer: F+O+Y+Er
fincar: F+In+C+Ar
cós: C+O+S
asséptico: As+Se+P+Ti+C+O
amorfo: Am+O+Rf+O
alucinar: Al+U+C+In+Ar
valeroso: V+Al+Er+O+S+O
positivismo: P+O+Si+Ti+V+I+S+Mo
Lara: La+Ra
Ivo: I+V+O
Fernão: F+Er+Na+O
Eric: Er+I+C
convalescer: C+O+N+V+Al+Es+C+Er
ceramista: C+Er+Am+I+S+Ta
carburante: C+Ar+B+U+Ra+N+Te
Plano: P+La+N+O
Orense: O+Re+N+Se
Natura: N+At+U+Ra
Luisinho: Lu+I+Si+N+H+O
Huíla: H+U+I+La
flautista: F+La+U+Ti+S+Ta
Filipa: F+I+Li+Pa
bip: B+I+P
vau: V+Au
pin: P+In
fatalista: F+At+Al+I+S+Ta
Chippo: C+H+I+P+P+O
canarinho: Ca+N+Ar+In+H+O
Branca: B+Ra+N+Ca
arnês: Ar+N+Es
Arco: Ar+C+O
sey: Se+Y
parenta: Pa+Re+N+Ta
inteirinho: In+Te+Ir+In+H+O
fender: Fe+Nd+Er
cavalinho: Ca+V+Al+In+H+O
agnóstico: Ag+N+O+S+Ti+C+O
Vitesse: V+I+Te+S+Se
Un: U+N
Taira: Ta+I+Ra
Cáritas: C+Ar+I+Ta+S
cash: C+As+H
bufete: B+U+Fe+Te
Boss: B+O+S+S
titânico: Ti+Ta+N+I+C+O
sionismo: Si+O+N+I+S+Mo
propano: Pr+O+Pa+N+O
Parece: Pa+Re+Ce
Nené: Ne+Ne
cãs: C+As
àcerco: Ac+Er+C+O
Callas: C+Al+La+S
bronco: Br+O+N+C+O
Bilro: B+I+Lr+O
alcantarense: Al+Ca+N+Ta+Re+N+Se
sineiro: Si+Ne+Ir+O
Rao: Ra+O
positivista: P+O+Si+Ti+V+I+S+Ta
narina: N+Ar+I+Na
lasso: La+S+S+O
hir: H+Ir
gelatina: Ge+La+Ti+Na
fusta: F+U+S+Ta
Estes: Es+Te+S
Copacabana: C+O+Pa+Ca+Ba+Na
Cocteau: C+O+C+Te+Au
Chagas: C+H+Ag+As
cambiar: C+Am+B+I+Ar
bago: B+Ag+O
aro: Ar+O
tiber: Ti+B+Er
rafeiro: Ra+Fe+Ir+O
Polisário: P+O+Li+S+Ar+I+O
Plutão: P+Lu+Ta+O
pioneirismo: P+I+O+Ne+Ir+I+S+Mo
parra: P+Ar+Ra
Início: In+I+C+I+O
incensar: In+Ce+N+S+Ar
ilusionista: I+Lu+Si+O+N+I+S+Ta
ilusionismo: I+Lu+Si+O+N+I+S+Mo
Gestapo: Ge+S+Ta+P+O
Fontenay: F+O+N+Te+Na+Y
Bihé: B+I+He
balancear: Ba+La+N+Ce+Ar
viso: V+I+S+O
Ste: S+Te
Sharif: S+H+Ar+I+F
rendoso: Re+Nd+O+S+O
poer: P+O+Er
pesaroso: P+Es+Ar+O+S+O
Monserrate: Mo+N+S+Er+Ra+Te
McKiernan: Mc+K+I+Er+Na+N
Knin: K+N+In
floco: Fl+O+C+O
estendal: Es+Te+Nd+Al
ativo: At+I+V+O
yo: Y+O
vagina: V+Ag+I+Na
Séneca: Se+Ne+Ca
pareceo: Pa+Re+Ce+O
Cronenberg: Cr+O+Ne+N+Be+Rg
caracara: Ca+Ra+Ca+Ra
Bola: B+O+La
Barak: Ba+Ra+K
arcano: Ar+Ca+N+O
revisionista: Re+V+I+Si+O+N+I+S+Ta
patogênico: P+At+O+Ge+N+I+C+O
monolítico: Mo+N+O+Li+Ti+C+O
how: H+O+W
herpes: H+Er+P+Es
Fe: Fe
Condestá: C+O+Nd+Es+Ta
coice: C+O+I+Ce
Calvino: C+Al+V+In+O
Rubens: Ru+Be+N+S
placebo: P+La+Ce+B+O
Pinerfo: P+In+Er+F+O
Lúcio: Lu+C+I+O
Iliescu: I+Li+Es+C+U
confessionário: C+O+N+F+Es+Si+O+N+Ar+I+O
cFC: C+F+C
bramar: Br+Am+Ar
tatear: Ta+Te+Ar
refratário: Re+Fr+At+Ar+I+O
Plavsic: P+La+V+Si+C
Pataias: Pa+Ta+I+As
palá: Pa+La
contender: C+O+N+Te+Nd+Er
côncavo: C+O+N+Ca+V+O
balofo: B+Al+O+F+O
Aurélio: Au+Re+Li+O
Siga: Si+Ga
rasgão: Ra+S+Ga+O
Poiares: P+O+I+Ar+Es
pina: P+I+Na
monográfico: Mo+N+Og+Ra+F+I+C+O
luterano: Lu+Te+Ra+N+O
Crossfire: Cr+O+S+S+F+I+Re
Bonino: B+O+N+In+O
berrante: B+Er+Ra+N+Te
Bambo: B+Am+B+O
acne: Ac+Ne
Smiths: Sm+I+Th+S
silvo: Si+Lv+O
Rus: Ru+S
picareta: P+I+Ca+Re+Ta
fracionar: F+Ra+C+I+O+N+Ar
fiesta: F+I+Es+Ta
crustáceo: C+Ru+S+Ta+Ce+O
chauvinismo: C+H+Au+V+In+I+S+Mo
cervical: C+Er+V+I+C+Al
Aus: Au+S
tirante: Ti+Ra+N+Te
ondulante: O+Nd+U+La+N+Te
Libra: Li+B+Ra
hoc: H+O+C
espinal: Es+P+In+Al
Chostakovitch: C+H+O+S+Ta+K+O+V+I+Tc+H
Ceo: Ce+O
Ban: Ba+N
very: V+Er+Y
persona: P+Er+S+O+Na
pausar: P+Au+S+Ar
moralismo: Mo+Ra+Li+S+Mo
montepio: Mo+N+Te+P+I+O
Koch: K+O+C+H
chacinar: C+H+Ac+In+Ar
Catherine: C+At+H+Er+I+Ne
camaronês: C+Am+Ar+O+N+Es
Bonga: B+O+N+Ga
auer: Au+Er
vesícula: V+Es+I+C+U+La
srs: Sr+S
Sierra: Si+Er+Ra
Sheraton: S+H+Er+At+O+N
Resnais: Re+S+Na+I+S
Farias: F+Ar+I+As
esp: Es+P
cibernético: C+I+B+Er+Ne+Ti+C+O
cEO: Ce+O
Camacho: C+Am+Ac+H+O
assear: As+Se+Ar
rendar: Re+Nd+Ar
Proteste: Pr+O+Te+S+Te
oscilante: O+S+C+I+La+N+Te
lunático: Lu+N+At+I+C+O
Fnac: F+N+Ac
calote: C+Al+O+Te
Butler: B+U+Tl+Er
baga: Ba+Ga
suástica: S+U+As+Ti+Ca
sarauis: S+Ar+Au+I+S
Profissional: Pr+O+F+I+S+Si+O+N+Al
Nereu: N+Er+Eu
Nasoni: N+As+O+N+I
confinante: C+O+N+F+I+Na+N+Te
cheo: C+He+O
brevíssimo: B+Re+V+I+S+Si+Mo
Bobby: B+O+B+B+Y
biscate: B+I+S+Ca+Te
Waco: W+Ac+O
stico: S+Ti+C+O
Senhores: Se+N+H+O+Re+S
relacional: Re+La+C+I+O+N+Al
percussivo: P+Er+C+U+S+Si+V+O
nec: Ne+C
Luso: Lu+S+O
gaúcho: Ga+U+C+H+O
frutífero: F+Ru+Ti+F+Er+O
feérico: Fe+Er+I+C+O
cros: Cr+O+S
baba: Ba+Ba
tacão: Ta+Ca+O
revirar: Re+V+Ir+Ar
Putin: P+U+Ti+N
Mónica: Mo+N+I+Ca
internacionalismo: In+Te+Rn+Ac+I+O+N+Al+I+S+Mo
Festa: F+Es+Ta
chauvinista: C+H+Au+V+In+I+S+Ta
Bucks: B+U+C+K+S
ater: At+Er
tirana: Ti+Ra+Na
Samper: S+Am+P+Er
panar: Pa+N+Ar
McCoy: Mc+C+O+Y
liv: Li+V
lady: La+Dy
inoperacional: In+O+P+Er+Ac+I+O+N+Al
genovês: Ge+N+O+V+Es
gaiato: Ga+I+At+O
espinafre: Es+P+I+Na+F+Re
Carmona: C+Ar+Mo+Na
Vinicius: V+In+I+C+I+U+S
tísico: Ti+Si+C+O
Shas: S+H+As
session: S+Es+Si+O+N
page: Pa+Ge
nonsense: N+O+N+Se+N+Se
nesga: N+Es+Ga
Lapa: La+Pa
Ihe: I+He
hierático: H+I+Er+At+I+C+O
Génio: Ge+N+I+O
Flávio: F+La+V+I+O
clavícula: C+La+V+I+C+U+La
cerealífero: Ce+Re+Al+I+F+Er+O
carte: C+Ar+Te
sovar: S+O+V+Ar
sibilino: Si+B+I+Li+N+O
Regente: Re+Ge+N+Te
pornô: P+O+Rn+O
pericial: P+Er+I+C+I+Al
peúga: P+Eu+Ga
Panasonic: Pa+N+As+O+N+I+C
oscar: O+S+C+Ar
Icep: I+Ce+P
Furnas: F+U+Rn+As
cubana: C+U+Ba+Na
Contas: C+O+N+Ta+S
Berg: Be+Rg
talão: Ta+La+O
tê: Te
Republica: Re+P+U+B+Li+Ca
Protali: Pr+O+Ta+Li
Plínio: P+Li+N+I+O
pd: Pd
Gav: Ga+V
Fronteira: Fr+O+N+Te+I+Ra
fenecer: Fe+Ne+C+Er
cubista: C+U+B+I+S+Ta
cercanias: C+Er+Ca+N+I+As
Buarcos: B+U+Ar+C+O+S
Bayreuth: Ba+Y+Re+U+Th
Austin: Au+S+Ti+N
Vogts: V+Og+Ts
Tabucchi: Ta+B+U+C+C+H+I
puré: P+U+Re
Prosiurb: Pr+O+Si+U+Rb
Moreno: Mo+Re+N+O
Fauré: F+Au+Re
carvalhal: C+Ar+V+Al+H+Al
Boticas: B+O+Ti+C+As
Bismarck: B+I+Sm+Ar+C+K
tipográfico: Ti+P+Og+Ra+F+I+C+O
thi: Th+I
Shearer: S+He+Ar+Er
repisar: Re+P+I+S+Ar
píncaro: P+In+C+Ar+O
Chubais: C+H+U+Ba+I+S
Carachi: C+Ar+Ac+H+I
calcio: C+Al+C+I+O
beliche: Be+Li+C+He
Balbina: B+Al+B+I+Na
senhorear: Se+N+H+O+Re+Ar
Punisic: P+U+N+I+Si+C
pan: Pa+N
Orange: O+Ra+N+Ge
neolítico: Ne+O+Li+Ti+C+O
Liberato: Li+B+Er+At+O
Eugenio: Eu+Ge+N+I+O
escrutinar: Es+C+Ru+Ti+N+Ar
calculismo: C+Al+C+U+Li+S+Mo
arbóreo: Ar+B+O+Re+O
Voynov: V+O+Y+N+O+V
Valério: V+Al+Er+I+O
reinvindicar: Re+In+V+I+Nd+I+C+Ar
recobrir: Re+C+O+Br+Ir
mousse: Mo+U+S+Se
Lindoso: Li+Nd+O+S+O
húngara: H+U+N+Ga+Ra
fulvo: F+U+Lv+O
fálico: F+Al+I+C+O
confisco: C+O+N+F+I+S+C+O
titã: Ti+Ta
tarefeiro: Ta+Re+Fe+Ir+O
sereníssimo: Se+Re+N+I+S+Si+Mo
prumo: P+Ru+Mo
polas: P+O+La+S
Parabéns: Pa+Ra+Be+N+S
galinheiro: Ga+Li+N+He+Ir+O
frasear: F+Ra+Se+Ar
Fnam: F+N+Am
florete: Fl+O+Re+Te
cincar: C+In+C+Ar
ben: Be+N
Aghini: Ag+H+In+I
Stern: S+Te+Rn
Ruas: Ru+As
reboco: Re+B+O+C+O
peronista: P+Er+O+N+I+S+Ta
Linhares: Li+N+H+Ar+Es
hospício: H+O+S+P+I+C+I+O
ficcionista: F+I+C+C+I+O+N+I+S+Ta
errático: Er+Ra+Ti+C+O
Cresson: C+Re+S+S+O+N
cover: C+O+V+Er
choupana: C+H+O+U+Pa+Na
celibatário: Ce+Li+B+At+Ar+I+O
cavernoso: Ca+V+Er+N+O+S+O
artificialismo: Ar+Ti+F+I+C+I+Al+I+S+Mo
vocacional: V+O+C+Ac+I+O+N+Al
tara: Ta+Ra
sarauí: S+Ar+Au+I
pita: P+I+Ta
natura: N+At+U+Ra
Monica: Mo+N+I+Ca
Espanhas: Es+Pa+N+H+As
clown: Cl+O+W+N
chocalho: C+H+O+C+Al+H+O
campino: C+Am+P+In+O
tablier: Ta+B+Li+Er
Reservas: Re+S+Er+V+As
ratio: Ra+Ti+O
Políticas: P+O+Li+Ti+C+As
Pero: P+Er+O
pícaro: P+I+C+Ar+O
parassocial: P+Ar+As+S+O+C+I+Al
palrar: Pa+Lr+Ar
moura: Mo+U+Ra
Moore: Mo+O+Re
isolacionismo: I+S+O+La+C+I+O+N+I+S+Mo
coliseu: C+O+Li+S+Eu
Chirinola: C+H+Ir+In+O+La
chicanar: C+H+I+Ca+N+Ar
Chen: C+He+N
Beta: Be+Ta
Barny: B+Ar+N+Y
Bakero: Ba+K+Er+O
american: Am+Er+I+Ca+N
tirânico: Ti+Ra+N+I+C+O
Sendero: Se+Nd+Er+O
pinheiral: P+In+He+Ir+Al
Pinatubo: P+In+At+U+B+O
paginar: P+Ag+In+Ar
né: Ne
Kinnock: K+In+N+O+C+K
inestético: In+Es+Te+Ti+C+O
concubina: C+O+N+C+U+B+I+Na
bacoco: B+Ac+O+C+O
ysso: Y+S+S+O
Vos: V+O+S
pêsames: P+Es+Am+Es
polifônico: P+O+Li+F+O+N+I+C+O
pack: P+Ac+K
Lafontaine: La+F+O+N+Ta+I+Ne
figa: F+I+Ga
crismar: Cr+I+Sm+Ar
céo: Ce+O
carteirista: C+Ar+Te+Ir+I+S+Ta
Camus: C+Am+U+S
campanário: C+Am+Pa+N+Ar+I+O
tiuer: Ti+U+Er
silício: Si+Li+C+I+O
siamês: Si+Am+Es
Seis: Se+I+S
prolífico: Pr+O+Li+F+I+C+O
polinésio: P+O+Li+N+Es+I+O
Onofre: O+N+O+F+Re
life: Li+Fe
Céline: Ce+Li+Ne
cavalheiresco: Ca+V+Al+He+I+Re+S+C+O
broker: Br+O+K+Er
Bravo: B+Ra+V+O
Attali: At+Ta+Li
arranco: Ar+Ra+N+C+O
alvarinho: Al+V+Ar+In+H+O
Alicante: Al+I+Ca+N+Te
Vita: V+I+Ta
superliga: S+U+P+Er+Li+Ga
Obras: O+B+Ra+S
Nagano: Na+Ga+N+O
Nablus: Na+B+Lu+S
moliceiro: Mo+Li+Ce+Ir+O
Lubitsch: Lu+B+I+Ts+C+H
genero: Ge+N+Er+O
Final: F+In+Al
fetiche: Fe+Ti+C+He
Clareta: C+La+Re+Ta
arrebanhar: Ar+Re+Ba+N+H+Ar
Walker: W+Al+K+Er
Tass: Ta+S+S
Swatch: S+W+At+C+H
recambiar: Re+C+Am+B+I+Ar
planar: P+La+N+Ar
paganismo: Pa+Ga+N+I+S+Mo
Ligeti: Li+Ge+Ti
his: H+I+S
funchal: F+U+N+C+H+Al
Cosec: C+O+Se+C
choupal: C+H+O+U+P+Al
caviar: Ca+V+I+Ar
baby: Ba+B+Y
Amora: Am+O+Ra
White: W+H+I+Te
Uno: U+N+O
snob: S+N+O+B
reta: Re+Ta
rabiscar: Ra+B+I+S+C+Ar
pataco: P+At+Ac+O
Papon: Pa+P+O+N
monteirista: Mo+N+Te+Ir+I+S+Ta
Franklin: F+Ra+N+K+Li+N
fouce: F+O+U+Ce
Crisfal: Cr+I+S+F+Al
Casal: C+As+Al
caír: Ca+Ir
cafre: Ca+F+Re
Baresi: B+Ar+Es+I
arcaísmo: Ar+Ca+I+S+Mo
Aluno: Al+U+N+O
Pernes: P+Er+N+Es
Pawlak: Pa+W+La+K
ouuir: O+U+U+Ir
fiambre: F+I+Am+B+Re
cosmo: C+O+S+Mo
Ciampi: C+I+Am+P+I
bonacheirão: B+O+N+Ac+He+I+Ra+O
aragonês: Ar+Ag+O+N+Es
Amal: Am+Al
alibi: Al+I+B+I
Titina: Ti+Ti+Na
Será: Se+Ra
Samora: S+Am+O+Ra
Pitico: P+I+Ti+C+O
obelisco: O+Be+Li+S+C+O
herbanário: H+Er+Ba+N+Ar+I+O
genebra: Ge+Ne+B+Ra
ganir: Ga+N+Ir
fotão: F+O+Ta+O
club: C+Lu+B
carolice: C+Ar+O+Li+Ce
canibalismo: Ca+N+I+B+Al+I+S+Mo
can: Ca+N
bis: B+I+S
bin: B+In
altear: Al+Te+Ar
Watson: W+At+S+O+N
Vários: V+Ar+I+O+S
Urais: U+Ra+I+S
Sumolis: S+U+Mo+Li+S
so: S+O
snack: S+N+Ac+K
Rubin: Ru+B+In
Pocinho: P+O+C+In+H+O
Panis: Pa+N+I+S
Hélio: He+Li+O
Courage: C+O+U+Ra+Ge
clarinetista: Cl+Ar+I+Ne+Ti+S+Ta
calibrar: C+Al+I+Br+Ar
Cacioli: C+Ac+I+O+Li
berra: B+Er+Ra
balseiro: B+Al+Se+Ir+O
activismo: Ac+Ti+V+I+S+Mo
supersônico: S+U+P+Er+S+O+N+I+C+O
René: Re+Ne
Parreira: P+Ar+Re+I+Ra
palacio: P+Al+Ac+I+O
money: Mo+Ne+Y
Lafões: La+F+O+Es
kiwi: K+I+W+I
hipopótamo: H+I+P+O+P+O+Ta+Mo
ham: H+Am
champô: C+H+Am+P+O
Catão: Ca+Ta+O
brita: Br+I+Ta
Raposo: Ra+P+O+S+O
preclaro: P+Re+Cl+Ar+O
pouso: P+O+U+S+O
Oasis: O+As+I+S
espartano: Es+P+Ar+Ta+N+O
cânhamo: Ca+N+H+Am+O
certa: C+Er+Ta
Blanc: B+La+N+C
beirã: Be+I+Ra
Barnes: B+Ar+N+Es
Aragon: Ar+Ag+O+N
tafetá: Ta+Fe+Ta
sincopar: Si+N+C+O+P+Ar
Scala: S+Ca+La
planura: P+La+N+U+Ra
official: O+F+F+I+C+I+Al
Mons: Mo+N+S
cólica: C+O+Li+Ca
Caterina: C+At+Er+I+Na
Capitão: Ca+P+I+Ta+O
Ben: Be+N
vita: V+I+Ta
vintage: V+In+Ta+Ge
verônica: V+Er+O+N+I+Ca
samurai: S+Am+U+Ra+I
relancear: Re+La+N+Ce+Ar
plangente: P+La+N+Ge+N+Te
lacrimoso: La+Cr+I+Mo+S+O
ingente: In+Ge+N+Te
hipotecário: H+I+P+O+Te+C+Ar+I+O
espargo: Es+Pa+Rg+O
crina: Cr+I+Na
Cooper: C+O+O+P+Er
coalhar: C+O+Al+H+Ar
Clip: C+Li+P
cacete: Ca+Ce+Te
Wisconsin: W+I+S+C+O+N+Si+N
Stanic: S+Ta+N+I+C
racionar: Ra+C+I+O+N+Ar
preciosismo: P+Re+C+I+O+Si+S+Mo
genica: Ge+N+I+Ca
Flora: Fl+O+Ra
estéreo: Es+Te+Re+O
Cosmos: C+O+S+Mo+S
cãibra: Ca+I+B+Ra
capota: Ca+P+O+Ta
cachalote: C+Ac+H+Al+O+Te
beat: Be+At
Bana: Ba+Na
vésperas: V+Es+P+Er+As
Viterbo: V+I+Te+Rb+O
Ver: V+Er
Talabani: Ta+La+Ba+N+I
Sutherland: S+U+Th+Er+La+Nd
States: S+Ta+Te+S
Soci: S+O+C+I
raspão: Ra+S+Pa+O
Ponte: P+O+N+Te
ponderoso: P+O+Nd+Er+O+S+O
parêntese: Pa+Re+N+Te+Se
niilismo: N+I+I+Li+S+Mo
Lucena: Lu+Ce+Na
Lubbers: Lu+B+B+Er+S
Kubrick: K+U+Br+I+C+K
Inhambane: In+H+Am+Ba+Ne
inepto: I+Ne+Pt+O
Hesse: H+Es+Se
Georgina: Ge+O+Rg+I+Na
Frexes: F+Re+Xe+S
Ferencvaros: Fe+Re+N+C+V+Ar+O+S
facilitismo: F+Ac+I+Li+Ti+S+Mo
cIC: C+I+C
Carreras: C+Ar+Re+Ra+S
Téchiné: Te+C+H+I+Ne
selvático: Se+Lv+At+I+C+O
scene: S+Ce+Ne
relicário: Re+Li+C+Ar+I+O
Picoas: P+I+C+O+As
Limoges: Li+Mo+Ge+S
incluso: In+C+Lu+S+O
Husseini: H+U+S+Se+In+I
homónimo: H+O+Mo+N+I+Mo
corante: C+O+Ra+N+Te
Cabo: Ca+B+O
soslaio: S+O+S+La+I+O
Shéu: S+H+Eu
propagandista: Pr+O+Pa+Ga+Nd+I+S+Ta
perseverar: P+Er+Se+V+Er+Ar
Oscar: O+S+C+Ar
Negage: Ne+Ga+Ge
Mounir: Mo+U+N+Ir
lubrificante: Lu+Br+I+F+I+Ca+N+Te
álamo: Al+Am+O
Khatami: K+H+At+Am+I
imo: I+Mo
Flo: Fl+O
fólio: F+O+Li+O
cuco: C+U+C+O
cromo: Cr+O+Mo
cooptar: C+O+O+Pt+Ar
Canelas: Ca+Ne+La+S
varina: V+Ar+I+Na
stá: S+Ta
Reynos: Re+Y+N+O+S
purgar: P+U+Rg+Ar
Montesinho: Mo+N+Te+Si+N+H+O
lasca: La+S+Ca
Kiki: K+I+K+I
crecer: C+Re+C+Er
che: C+He
Can: Ca+N
Brá: B+Ra
acusativo: Ac+U+S+At+I+V+O
viseira: V+I+Se+I+Ra
universalismo: U+N+I+V+Er+S+Al+I+S+Mo
supa: S+U+Pa
rácico: Ra+C+I+C+O
pPP: P+P+P
pi: P+I
perfeccionista: P+Er+Fe+C+C+I+O+N+I+S+Ta
morabitino: Mo+Ra+B+I+Ti+N+O
Lulu: Lu+Lu
Ipamb: I+P+Am+B
Hook: H+O+O+K
Falla: F+Al+La
Cousteau: C+O+U+S+Te+Au
Cage: Ca+Ge
braseiro: B+Ra+Se+Ir+O
body: B+O+Dy
Bauhaus: B+Au+H+Au+S
virote: V+Ir+O+Te
sinopse: Si+N+O+P+Se
proxeneta: Pr+O+Xe+Ne+Ta
presencial: P+Re+Se+N+C+I+Al
Políbio: P+O+Li+B+I+O
Pantani: Pa+N+Ta+N+I
Orestes: O+Re+S+Te+S
ínvio: In+V+I+O
nobi: N+O+B+I
ínicio: In+I+C+I+O
monossílabo: Mo+N+O+S+Si+La+B+O
liamba: Li+Am+Ba
Land: La+Nd
frisson: Fr+I+S+S+O+N
Falcon: F+Al+C+O+N
espírita: Es+P+Ir+I+Ta
esófago: Es+O+F+Ag+O
causal: C+Au+S+Al
carocho: C+Ar+O+C+H+O
bufar: B+U+F+Ar
Acarte: Ac+Ar+Te
vobi: V+O+B+I
vespa: V+Es+Pa
Tirésias: Ti+Re+Si+As
pasmoso: P+As+Mo+S+O
Pascal: P+As+C+Al
fusco: F+U+S+C+O
farra: F+Ar+Ra
clicar: C+Li+C+Ar
chicana: C+H+I+Ca+Na
bluesy: B+Lu+Es+Y
arsénico: Ar+Se+N+I+C+O
argelina: Ar+Ge+Li+Na
tever: Te+V+Er
tanga: Ta+N+Ga
salmonela: S+Al+Mo+Ne+La
Paco: P+Ac+O
Namibe: N+Am+I+Be
Kirsten: K+Ir+S+Te+N
ingenho: In+Ge+N+H+O
inebriar: I+Ne+Br+I+Ar
gen: Ge+N
Febo: Fe+B+O
Chamusca: C+H+Am+U+S+Ca
cevar: Ce+V+Ar
ceo: Ce+O
Cendrev: Ce+Nd+Re+V
cantante: Ca+N+Ta+N+Te
Brando: B+Ra+Nd+O
Bond: B+O+Nd
Bergen: B+Er+Ge+N
balar: B+Al+Ar
alisar: Al+I+S+Ar
alheo: Al+He+O
servilismo: S+Er+V+I+Li+S+Mo
reynar: Re+Y+N+Ar
Pau: P+Au
Noga: N+O+Ga
Montana: Mo+N+Ta+Na
Indy: In+Dy
halo: H+Al+O
esposar: Es+P+O+S+Ar
esbofetear: Es+B+O+Fe+Te+Ar
busílis: B+U+Si+Li+S
batelão: Ba+Te+La+O
amotinar: Am+O+Ti+N+Ar
vinheta: V+In+He+Ta
pressagiar: P+Re+S+S+Ag+I+Ar
Poceirão: P+O+Ce+I+Ra+O
Nina: N+I+Na
lanchar: La+N+C+H+Ar
irra: Ir+Ra
inativar: In+At+I+V+Ar
inapto: I+Na+Pt+O
ih: I+H
book: B+O+O+K
arreio: Ar+Re+I+O
Algeciras: Al+Ge+C+I+Ra+S
acicatar: Ac+I+C+At+Ar
Voyager: V+O+Y+Ag+Er
salso: S+Al+S+O
rasteirar: Ra+S+Te+Ir+Ar
palhota: P+Al+H+O+Ta
oficinal: O+F+I+C+In+Al
livreira: Li+V+Re+I+Ra
internauta: In+Te+Rn+Au+Ta
Fusco: F+U+S+C+O
fecal: Fe+C+Al
Crespo: C+Re+S+P+O
Casiraghi: C+As+Ir+Ag+H+I
cache: C+Ac+He
varino: V+Ar+In+O
tifosi: Ti+F+O+Si
Temos: Te+Mo+S
sound: S+O+U+Nd
salpicão: S+Al+P+I+Ca+O
recitativo: Re+C+I+Ta+Ti+V+O
popularucho: P+O+P+U+La+Ru+C+H+O
Popov: P+O+P+O+V
plástica: P+La+S+Ti+Ca
púbico: P+U+B+I+C+O
paio: Pa+I+O
niilista: N+I+I+Li+S+Ta
Nick: N+I+C+K
Nafta: Na+F+Ta
geofísico: Ge+O+F+I+Si+C+O
falsário: F+Al+S+Ar+I+O
Eureko: Eu+Re+K+O
Cossiga: C+O+S+Si+Ga
castanheira: C+As+Ta+N+He+I+Ra
bos: B+O+S
Baroni: B+Ar+O+N+I
Alfonso: Al+F+O+N+S+O
vibrato: V+I+Br+At+O
vaginal: V+Ag+In+Al
Spartak: S+P+Ar+Ta+K
snooker: S+N+O+O+K+Er
Simonyi: Si+Mo+N+Y+I
Remo: Re+Mo
Parnaso: P+Ar+N+As+O
papoila: Pa+P+O+I+La
papista: Pa+P+I+S+Ta
Pag: P+Ag
Once: O+N+Ce
nauio: N+Au+I+O
linchar: Li+N+C+H+Ar
Lib: Li+B
Kouba: K+O+U+Ba
ipso: I+P+S+O
Geota: Ge+O+Ta
fisioterapeuta: F+I+Si+O+Te+Ra+P+Eu+Ta
Citibank: C+I+Ti+Ba+N+K
cindir: C+I+Nd+Ir
boat: B+O+At
Barreiros: B+Ar+Re+Ir+O+S
amuo: Am+U+O
vesúvio: V+Es+U+V+I+O
surfar: S+U+Rf+Ar
Prosinecki: Pr+O+Si+Ne+C+K+I
Pop: P+O+P
Lu: Lu
huno: H+U+N+O
Ganges: Ga+N+Ge+S
festão: F+Es+Ta+O
Fesete: Fe+Se+Te
carpa: C+Ar+Pa
babuíno: Ba+B+U+In+O
arrufo: Ar+Ru+F+O
upa: U+Pa
Tebas: Te+B+As
prouer: Pr+O+U+Er
livrete: Li+V+Re+Te
Fitei: F+I+Te+I
eros: Er+O+S
Ceira: Ce+I+Ra
camp: C+Am+P
Brisbane: Br+I+S+Ba+Ne
biosfera: B+I+O+S+Fe+Ra
bacon: B+Ac+O+N
arrais: Ar+Ra+I+S
alvar: Al+V+Ar
Alfena: Al+Fe+Na
unifamiliar: U+N+I+F+Am+I+Li+Ar
subcontinente: S+U+B+C+O+N+Ti+Ne+N+Te
Sonatrach: S+O+N+At+Ra+C+H
psicótico: P+Si+C+O+Ti+C+O
over: O+V+Er
omner: O+Mn+Er
Observer: O+B+S+Er+V+Er
Nabokov: Na+B+O+K+O+V
eucarístico: Eu+C+Ar+I+S+Ti+C+O
Cires: C+I+Re+S
catita: C+At+I+Ta
caprichar: Ca+Pr+I+C+H+Ar
Aspa: As+Pa
what: W+H+At
remoer: Re+Mo+Er
Racine: Ra+C+I+Ne
profuso: Pr+O+F+U+S+O
pousio: P+O+U+Si+O
Pouco: P+O+U+C+O
palheta: P+Al+He+Ta
Palace: Pa+La+Ce
pacifismo: P+Ac+I+F+I+S+Mo
Moon: Mo+O+N
Kirch: K+Ir+C+H
cilício: C+I+Li+C+I+O
cerimonioso: C+Er+I+Mo+N+I+O+S+O
cacifo: C+Ac+I+F+O
Bernès: Be+Rn+Es
varíola: V+Ar+I+O+La
supra: S+U+P+Ra
ski: S+K+I
reprise: Re+Pr+I+Se
Rentipar: Re+N+Ti+P+Ar
plasmar: P+La+Sm+Ar
Lacan: La+Ca+N
clarear: C+La+Re+Ar
Cartagena: C+Ar+Ta+Ge+Na
bopper: B+O+P+P+Er
Boksic: B+O+K+Si+C
bocca: B+O+C+Ca
Atlantic: At+La+N+Ti+C
rés: Re+S
Punta: P+U+N+Ta
Pioline: P+I+O+Li+Ne
Novo: N+O+V+O
hipnose: H+I+P+N+O+Se
fagote: F+Ag+O+Te
Estamos: Es+Ta+Mo+S
esmo: Es+Mo
clic: C+Li+C
chofre: C+H+O+F+Re
chiste: C+H+I+S+Te
Arcarons: Ar+C+Ar+O+N+S
alba: Al+Ba
sônico: S+O+N+I+C+O
Severino: Se+V+Er+In+O
recebeo: Re+Ce+Be+O
Olano: O+La+N+O
md: Md
lacrar: La+Cr+Ar
fermosas: F+Er+Mo+S+As
estivar: Es+Ti+V+Ar
Cartas: C+Ar+Ta+S
canoísta: Ca+N+O+I+S+Ta
vitícola: V+I+Ti+C+O+La
Soho: S+O+H+O
sô: S+O
placenta: P+La+Ce+N+Ta
púcaro: P+U+C+Ar+O
Paraná: Pa+Ra+Na
pô: P+O
Office: O+F+F+I+Ce
Nasser: N+As+S+Er
Kocinski: K+O+C+In+S+K+I
Hola: H+O+La
fogacho: F+O+Ga+C+H+O
Ferrara: F+Er+Ra+Ra
eucaliptal: Eu+C+Al+I+Pt+Al
cuba: C+U+Ba
convalescente: C+O+N+V+Al+Es+Ce+N+Te
colaborante: C+O+La+B+O+Ra+N+Te
Caso: C+As+O
Cameron: C+Am+Er+O+N
Alvarinho: Al+V+Ar+In+H+O
alcobacense: Al+C+O+Ba+Ce+N+Se
achincalhar: Ac+H+In+C+Al+H+Ar
Warp: W+Ar+P
tétano: Te+Ta+N+O
substanciar: S+U+B+S+Ta+N+C+I+Ar
Stendhal: S+Te+Nd+H+Al
Sobralinho: S+O+B+Ra+Li+N+H+O
pC: P+C
Moutinho: Mo+U+Ti+N+H+O
Island: I+S+La+Nd
Freire: F+Re+I+Re
ferreira: F+Er+Re+I+Ra
Ericsson: Er+I+C+S+S+O+N
Comores: C+O+Mo+Re+S
cibernauta: C+I+Be+Rn+Au+Ta
chambre: C+H+Am+B+Re
Cao: Ca+O
bragantino: B+Ra+Ga+N+Ti+N+O
babar: Ba+B+Ar
agiota: Ag+I+O+Ta
Woody: W+O+O+Dy
Vuvu: V+U+V+U
Vivi: V+I+V+I
Stein: S+Te+In
soccer: S+O+C+C+Er
Pirinéus: P+Ir+In+Eu+S
pira: P+I+Ra
Operário: O+P+Er+Ar+I+O
nunciatura: N+U+N+C+I+At+U+Ra
noute: N+O+U+Te
Notícias: N+O+Ti+C+I+As
nicar: N+I+C+Ar
Mt: Mt
Laurentino: La+U+Re+N+Ti+N+O
Iscal: I+S+C+Al
Hobbes: H+O+B+Be+S
Fraga: F+Ra+Ga
espiritismo: Es+P+Ir+I+Ti+S+Mo
corânico: C+O+Ra+N+I+C+O
cofiar: C+O+F+I+Ar
carreta: C+Ar+Re+Ta
capuchinho: Ca+P+U+C+H+In+H+O
capar: Ca+P+Ar
Canário: Ca+N+Ar+I+O
bolina: B+O+Li+Na
Boca: B+O+Ca
Steiner: S+Te+In+Er
season: Se+As+O+N
putativo: P+U+Ta+Ti+V+O
procriar: Pr+O+Cr+I+Ar
pirite: P+Ir+I+Te
Nono: N+O+N+O
nã: Na
gamo: Ga+Mo
estela: Es+Te+La
chorão: C+H+O+Ra+O
Cercal: C+Er+C+Al
beca: Be+Ca
batista: B+At+I+S+Ta
assoberbar: As+S+O+Be+Rb+Ar
asco: As+C+O
Alfeite: Al+Fe+I+Te
Albino: Al+B+In+O
Superbikes: S+U+P+Er+B+I+K+Es
ártico: Ar+Ti+C+O
profundíssimo: Pr+O+F+U+Nd+I+S+Si+Mo
poial: P+O+I+Al
hooliganismo: H+O+O+Li+Ga+N+I+S+Mo
geoestacionário: Ge+O+Es+Ta+C+I+O+N+Ar+I+O
genitivo: Ge+N+I+Ti+V+O
garboso: Ga+Rb+O+S+O
Conakry: C+O+Na+Kr+Y
Club: C+Lu+B
chifre: C+H+I+F+Re
batismo: B+At+I+S+Mo
teta: Te+Ta
tenístico: Te+N+I+S+Ti+C+O
tabla: Ta+B+La
sátiro: S+At+Ir+O
Sternberg: S+Te+Rn+Be+Rg
Stagecoach: S+Ta+Ge+C+O+Ac+H
soba: S+O+Ba
Sharp: S+H+Ar+P
recamar: Re+C+Am+Ar
Pioneer: P+I+O+Ne+Er
peralta: P+Er+Al+Ta
irir: Ir+Ir
hambúrguer: H+Am+B+U+Rg+U+Er
ferrete: F+Er+Re+Te
escalabitano: Es+Ca+La+B+I+Ta+N+O
copta: C+O+P+Ta
Conner: C+O+N+N+Er
colaboracionismo: C+O+La+B+O+Ra+C+I+O+N+I+S+Mo
cabrão: Ca+B+Ra+O
alpaca: Al+Pa+Ca
Walsh: W+Al+S+H
Uns: U+N+S
taipal: Ta+I+P+Al
Syberberg: S+Y+B+Er+Be+Rg
seruir: S+Er+U+Ir
sambar: S+Am+B+Ar
raynho: Ra+Y+N+H+O
prisioneira: Pr+I+Si+O+Ne+I+Ra
percepcionar: P+Er+Ce+P+C+I+O+N+Ar
org: O+Rg
McKinsey: Mc+K+In+Se+Y
litigante: Li+Ti+Ga+N+Te
huu: H+U+U
Gastão: Ga+S+Ta+O
cítara: C+I+Ta+Ra
cócora: C+O+C+O+Ra
Casino: C+As+In+O
Caritas: C+Ar+I+Ta+S
bacante: Ba+Ca+N+Te
vibrafone: V+I+B+Ra+F+O+Ne
sibila: Si+B+I+La
Pais: Pa+I+S
osseta: O+S+Se+Ta
Olivier: O+Li+V+I+Er
náo: Na+O
narcísico: N+Ar+C+I+Si+C+O
hacker: H+Ac+K+Er
Eufrates: Eu+F+Ra+Te+S
esteiro: Es+Te+Ir+O
escolástico: Es+C+O+La+S+Ti+C+O
cubismo: C+U+B+I+S+Mo
cônico: C+O+N+I+C+O
ciciar: C+I+C+I+Ar
chicotear: C+H+I+C+O+Te+Ar
carola: C+Ar+O+La
biogás: B+I+O+Ga+S
Bacon: B+Ac+O+N
Yassin: Y+As+Si+N
vivificar: V+I+V+I+F+I+C+Ar
Verlaine: V+Er+La+I+Ne
successo: S+U+C+C+Es+S+O
Srinagar: Sr+In+Ag+Ar
spero: S+P+Er+O
Sobral: S+O+Br+Al
republicar: Re+P+U+B+Li+C+Ar
prevaricar: P+Re+V+Ar+I+C+Ar
pontifical: P+O+N+Ti+F+I+C+Al
pero: P+Er+O
patusco: P+At+U+S+C+O
Parsifal: P+Ar+Si+F+Al
Nico: N+I+C+O
Hepburn: He+P+B+U+Rn
fisga: F+I+S+Ga
ferrão: F+Er+Ra+O
Felício: Fe+Li+C+I+O
Faustino: F+Au+S+Ti+N+O
clavina: C+La+V+I+Na
chacal: C+H+Ac+Al
castelão: C+As+Te+La+O
Bentes: Be+N+Te+S
banheiro: Ba+N+He+Ir+O
arreganhar: Ar+Re+Ga+N+H+Ar
Ambelis: Am+Be+Li+S
alvíssaras: Al+V+I+S+S+Ar+As
uni: U+N+I
tabanca: Ta+Ba+N+Ca
Soserfin: S+O+S+Er+F+In
sólio: S+O+Li+O
sensitivo: Se+N+Si+Ti+V+O
playboy: P+La+Y+B+O+Y
Paulina: P+Au+Li+Na
nauta: N+Au+Ta
Mc: Mc
Kirov: K+Ir+O+V
Friburgo: Fr+I+B+U+Rg+O
felá: Fe+La
fatigante: F+At+I+Ga+N+Te
Crónicas: Cr+O+N+I+C+As
couce: C+O+U+Ce
Camdessus: Ca+Md+Es+S+U+S
Bruckner: B+Ru+C+K+N+Er
broca: Br+O+Ca
breu: B+Re+U
Beck: Be+C+K
Basaúla: B+As+Au+La
valo: V+Al+O
Unifer: U+N+I+F+Er
Tibães: Ti+Ba+Es
Tasso: Ta+S+S+O
Serrano: S+Er+Ra+N+O
Rusedski: Ru+Se+Ds+K+I
regabofe: Re+Ga+B+O+Fe
posicional: P+O+Si+C+I+O+N+Al
Platini: P+La+Ti+N+I
plantio: P+La+N+Ti+O
Par: P+Ar
Palop: P+Al+O+P
nô: N+O
mt: Mt
lítio: Li+Ti+O
limo: Li+Mo
itálico: I+Ta+Li+C+O
Génesis: Ge+N+Es+I+S
Facar: F+Ac+Ar
Euora: Eu+O+Ra
esc: Es+C
cravista: C+Ra+V+I+S+Ta
Coluna: C+O+Lu+Na
chat: C+H+At
centenares: Ce+N+Te+N+Ar+Es
bananeira: Ba+Na+Ne+I+Ra
amoníaco: Am+O+N+I+Ac+O
Albertino: Al+B+Er+Ti+N+O
Acontece: Ac+O+N+Te+Ce
vasco: V+As+C+O
Tati: Ta+Ti
rectilíneo: Re+C+Ti+Li+Ne+O
Rebecca: Re+Be+C+Ca
Puna: P+U+Na
Populares: P+O+P+U+La+Re+S
np: N+P
limousine: Li+Mo+U+Si+Ne
fichar: F+I+C+H+Ar
escabeche: Es+Ca+Be+C+He
cripta: Cr+I+P+Ta
copla: C+O+P+La
Chi: C+H+I
Brabham: B+Ra+B+H+Am
arsenalista: Ar+Se+N+Al+I+S+Ta
viuo: V+I+U+O
Viola: V+I+O+La
Vieri: V+I+Er+I
sincrético: Si+N+C+Re+Ti+C+O
prestimoso: P+Re+S+Ti+Mo+S+O
Pindo: P+I+Nd+O
larguíssimo: La+Rg+U+I+S+Si+Mo
lacerar: La+C+Er+Ar
Forbs: F+O+Rb+S
fauce: F+Au+Ce
cascalho: C+As+C+Al+H+O
calheta: C+Al+He+Ta
bobina: B+O+B+I+Na
ampola: Am+P+O+La
Srs: Sr+S
spaspa: S+P+As+Pa
shows: S+H+O+W+S
profiláctico: Pr+O+F+I+La+C+Ti+C+O
probo: Pr+O+B+O
pavio: Pa+V+I+O
Pargeste: P+Ar+Ge+S+Te
paninho: Pa+N+In+H+O
libris: Li+Br+I+S
là: La
he: He
fauno: F+Au+N+O
espairecer: Es+Pa+I+Re+C+Er
esconso: Es+C+O+N+S+O
cherne: C+H+Er+Ne
bragar: Br+Ag+Ar
bisonho: B+I+S+O+N+H+O
atlantista: At+La+N+Ti+S+Ta
was: W+As
valiosíssimo: V+Al+I+O+Si+S+Si+Mo
unívoco: U+N+I+V+O+C+O
Shengen: S+He+N+Ge+N
sentencioso: Se+N+Te+N+C+I+O+S+O
scena: S+Ce+Na
saltitante: S+Al+Ti+Ta+N+Te
refundir: Re+F+U+Nd+Ir
recentíssimo: Re+Ce+N+Ti+S+Si+Mo
Pogues: P+Og+U+Es
Focus: F+O+C+U+S
cócega: C+O+Ce+Ga
botânica: B+O+Ta+N+I+Ca
bop: B+O+P
Bolinhas: B+O+Li+N+H+As
talibã: Ta+Li+Ba
Steffi: S+Te+F+F+I
solver: S+O+Lv+Er
Serrão: S+Er+Ra+O
Representante: Re+P+Re+Se+N+Ta+N+Te
reclamo: Re+C+La+Mo
Oliver: O+Li+V+Er
no: N+O
Nóbrega: N+O+B+Re+Ga
montanhismo: Mo+N+Ta+N+H+I+S+Mo
Lavra: La+V+Ra
Hi: H+I
famosíssimo: F+Am+O+Si+S+Si+Mo
cretino: C+Re+Ti+N+O
cisco: C+I+S+C+O
catalã: Ca+Ta+La
Besirovic: Be+S+Ir+O+V+I+C
asceta: As+Ce+Ta
Arrabal: Ar+Ra+B+Al
alcalino: Al+C+Al+In+O
tina: Ti+Na
Tibi: Ti+B+I
saltear: S+Al+Te+Ar
Rabbani: Ra+B+Ba+N+I
Professora: Pr+O+F+Es+S+O+Ra
Pik: P+I+K
ibero: I+B+Er+O
ganancioso: Ga+Na+N+C+I+O+S+O
Gabinete: Ga+B+I+Ne+Te
fosco: F+O+S+C+O
fetichista: Fe+Ti+C+H+I+S+Ta
Cheney: C+He+Ne+Y
canícula: Ca+N+I+C+U+La
calvinista: C+Al+V+In+I+S+Ta
br: Br
bas: B+As
baboso: Ba+B+O+S+O
Access: Ac+C+Es+S
vinco: V+In+C+O
sinusite: Si+N+U+Si+Te
sheik: S+He+I+K
reaccionarismo: Re+Ac+C+I+O+N+Ar+I+S+Mo
previsional: P+Re+V+I+Si+O+N+Al
politeísmo: P+O+Li+Te+I+S+Mo
Nise: N+I+Se
mofino: Mo+F+In+O
Lila: Li+La
hou: H+O+U
fátuo: F+At+U+O
Crestins: C+Re+S+Ti+N+S
Cincinnati: C+In+C+In+N+At+I
ceroulas: C+Er+O+U+La+S
Cernache: C+Er+N+Ac+He
caminheiro: C+Am+In+He+Ir+O
cambista: C+Am+B+I+S+Ta
bofe: B+O+Fe
beiral: Be+Ir+Al
Sogeval: S+O+Ge+V+Al
ruina: Ru+I+Na
protéico: Pr+O+Te+I+C+O
pratinho: P+Ra+Ti+N+H+O
Pias: P+I+As
Pialat: P+I+Al+At
perfeccionismo: P+Er+Fe+C+C+I+O+N+I+S+Mo
Passeio: P+As+Se+I+O
narcisista: N+Ar+C+I+Si+S+Ta
momo: Mo+Mo
librar: Li+Br+Ar
Laser: La+S+Er
Kiss: K+I+S+S
Kiptanui: K+I+P+Ta+N+U+I
ice: I+Ce
Florestas: Fl+O+Re+S+Ta+S
Falstaff: F+Al+S+Ta+F+F
Cunene: C+U+Ne+Ne
carbônico: C+Ar+B+O+N+I+C+O
Calhau: C+Al+H+Au
Albertini: Al+B+Er+Ti+N+I
Sunderland: S+U+Nd+Er+La+Nd
refundar: Re+F+U+Nd+Ar
Nicola: N+I+C+O+La
eunuco: Eu+N+U+C+O
coiro: C+O+Ir+O
Cheers: C+He+Er+S
Carver: C+Ar+V+Er
Capriati: Ca+Pr+I+At+I
Brooks: Br+O+O+K+S
Brescialat: B+Re+S+C+I+Al+At
Borg: B+O+Rg
Www: W+W+W
Wu: W+U
Ual: U+Al
taberneiro: Ta+B+Er+Ne+Ir+O
séptico: Se+P+Ti+C+O
Serifo: S+Er+I+F+O
seráfico: Se+Ra+F+I+C+O
Senete: Se+Ne+Te
Press: P+Re+S+S
Paganini: Pa+Ga+N+In+I
offshore: O+F+F+S+H+O+Re
nobiliário: N+O+B+I+Li+Ar+I+O
Koresh: K+O+Re+S+H
geneticista: Ge+Ne+Ti+C+I+S+Ta
Gene: Ge+Ne
Galinheiras: Ga+Li+N+He+I+Ra+S
Ferguson: Fe+Rg+U+S+O+N
Erasmo: Er+As+Mo
Céu: C+Eu
Creoula: C+Re+O+U+La
cognac: C+Og+N+Ac
clinicar: C+Li+N+I+C+Ar
bisca: B+I+S+Ca
bicéfalo: B+I+Ce+F+Al+O
Barreirense: B+Ar+Re+I+Re+N+Se
Alagoas: Al+Ag+O+As
timo: Ti+Mo
Salonen: S+Al+O+Ne+N
salomônico: S+Al+O+Mo+N+I+C+O
policiarista: P+O+Li+C+I+Ar+I+S+Ta
patinho: P+At+In+H+O
Nota: N+O+Ta
Latina: La+Ti+Na
insalubre: In+S+Al+U+B+Re
Inforgal: In+F+O+Rg+Al
ibi: I+B+I
escovar: Es+C+O+V+Ar
erat: Er+At
burundês: B+U+Ru+Nd+Es
Braval: B+Ra+V+Al
Bra: B+Ra
tita: Ti+Ta
remoinho: Re+Mo+In+H+O
preponderar: P+Re+P+O+Nd+Er+Ar
laconismo: La+C+O+N+I+S+Mo
Foy: F+O+Y
foreiro: F+O+Re+Ir+O
Corgo: C+O+Rg+O
cabalístico: Ca+B+Al+I+S+Ti+C+O
Buba: B+U+Ba
Balibó: B+Al+I+B+O
Bac: B+Ac
altaneiro: Al+Ta+Ne+Ir+O
vu: V+U
ático: At+I+C+O
slick: S+Li+C+K
senderista: Se+Nd+Er+I+S+Ta
sacola: S+Ac+O+La
rand: Ra+Nd
psicoterapeuta: P+Si+C+O+Te+Ra+P+Eu+Ta
Professores: Pr+O+F+Es+S+O+Re+S
núbio: N+U+B+I+O
Ipswich: I+P+S+W+I+C+H
incender: In+Ce+Nd+Er
funéreo: F+U+Ne+Re+O
Capirossi: Ca+P+Ir+O+S+Si
Calais: Ca+La+I+S
bretã: B+Re+Ta
Acop: Ac+O+P
titler: Ti+Tl+Er
tamto: Ta+Mt+O
tacanho: Ta+Ca+N+H+O
Taba: Ta+Ba
socapa: S+O+Ca+Pa
soarismo: S+O+Ar+I+S+Mo
Ruben: Ru+Be+N
rena: Re+Na
ranhura: Ra+N+H+U+Ra
Ramon: Ra+Mo+N
plaga: P+La+Ga
Nora: N+O+Ra
copista: C+O+P+I+S+Ta
Clóvis: Cl+O+V+I+S
Chéreau: C+He+Re+Au
carranca: C+Ar+Ra+N+Ca
carão: Ca+Ra+O
cabotino: Ca+B+O+Ti+N+O
bucho: B+U+C+H+O
Bierhoff: B+I+Er+H+O+F+F
barbo: B+Ar+B+O
ascetismo: As+Ce+Ti+S+Mo
windsurfista: W+In+Ds+U+Rf+I+S+Ta
uos: U+O+S
thatcherismo: Th+At+C+H+Er+I+S+Mo
supervisar: S+U+P+Er+V+I+S+Ar
sindicar: Si+Nd+I+C+Ar
prensar: P+Re+N+S+Ar
PanAm: Pa+N+Am
nervura: N+Er+V+U+Ra
Huber: H+U+B+Er
forasteira: F+O+Ra+S+Te+I+Ra
fontismo: F+O+N+Ti+S+Mo
cona: C+O+Na
Cesar: C+Es+Ar
Caribe: C+Ar+I+Be
biliar: B+I+Li+Ar
bicheiro: B+I+C+He+Ir+O
Barnabé: B+Ar+Na+Be
bá: Ba
ascese: As+Ce+Se
Alvaro: Al+V+Ar+O
Yves: Y+V+Es
Sui: S+U+I
Spirou: S+P+Ir+O+U
punch: P+U+N+C+H
publicista: P+U+B+Li+C+I+S+Ta
Progresso: Pr+Og+Re+S+S+O
principesco: Pr+In+C+I+P+Es+C+O
pálio: P+Al+I+O
ofuscante: O+F+U+S+Ca+N+Te
Io: I+O
inflacionário: In+F+La+C+I+O+N+Ar+I+O
Hipócrates: H+I+P+O+C+Ra+Te+S
falsete: F+Al+Se+Te
Espero: Es+P+Er+O
cético: Ce+Ti+C+O
Covões: C+O+V+O+Es
copinho: C+O+P+In+H+O
Conacri: C+O+Na+Cr+I
Cobain: C+O+Ba+In
Bresson: B+Re+S+S+O+N
bílis: B+I+Li+S
arrecear: Ar+Re+Ce+Ar
alpinismo: Al+P+In+I+S+Mo
Yuran: Y+U+Ra+N
Viso: V+I+S+O
Tão: Ta+O
Tindersticks: Ti+Nd+Er+S+Ti+C+K+S
Thyssen: Th+Y+S+Se+N
Terêncio: Te+Re+N+C+I+O
Reti: Re+Ti
Raymond: Ra+Y+Mo+Nd
prà: P+Ra
polaina: P+O+La+I+Na
Patacas: P+At+Ac+As
montanhista: Mo+N+Ta+N+H+I+S+Ta
lupanar: Lu+Pa+N+Ar
Lúcifer: Lu+C+I+F+Er
kalashnikov: K+Al+As+H+N+I+K+O+V
Irina: Ir+I+Na
ficaraõ: F+I+Ca+Ra+O
escrete: Es+C+Re+Te
Coura: C+O+U+Ra
Clipper: C+Li+P+P+Er
civilista: C+I+V+I+Li+S+Ta
Carina: C+Ar+I+Na
Berlin: B+Er+Li+N
Acre: Ac+Re
Viver: V+I+V+Er
Sindicatos: Si+Nd+I+C+At+O+S
samaritano: S+Am+Ar+I+Ta+N+O
Ruth: Ru+Th
prélio: P+Re+Li+O
pitéu: P+I+Te+U
pernoita: P+Er+N+O+I+Ta
Park: P+Ar+K
mourão: Mo+U+Ra+O
Monte: Mo+N+Te
moca: Mo+Ca
lascar: La+S+C+Ar
labuta: La+B+U+Ta
Hitachi: H+I+Ta+C+H+I
Francos: F+Ra+N+C+O+S
fIP: F+I+P
Essas: Es+S+As
Céus: C+Eu+S
Câmaras: C+Am+Ar+As
Bengala: Be+N+Ga+La
bateira: Ba+Te+I+Ra
American: Am+Er+I+Ca+N
Alcains: Al+Ca+In+S
